Hh^Qhhf, Hh^Qhhf, Hh^Qhhf, Hh^Qhhf, Hh^Qhhf, Hh^Qhhf, Hh^Qhhf, Gg^Qhhf, Gs^Qhhf, Gg^Qhhf, Gg^Qhhf, Gg^Qhhf, Gg^Qhhf, Gg^Qhhf, Gs^Qhhf, Gg^Qhhf, Gg, Re, Rb^Gvs, Rb^Gvs, Rb^Gvs, Re^Gvs, Re^Gvs, Re^Gvs, Gs^Fmw, Gs^Fmw, Gs^Fms, Gs^Fds, Gs^Fms, Gs^Fds
Hh, Hh, Hh, Hh^Fds, Hh^Fds, Hh^Fp, Hh^Fds, Gs^Fms, Gs^Fms, Gg^Fds, Gs^Fms, Gg^Efm, Gg^_mh, Gs^Fds, Gs^Qhhf, Gg, Re, 1 Re, Rb^Gvs, Rb^Gvs, Re^Wm, Re^Gvs, Re^Gvs, Gg^Eff, Gg^Eff, Gs^Fmw, Gs^Fms, Gs^Fmw, Gs^Fms, Gs^Fds
Hh, Hh, Hh^Fds, Hh, Gs, Gs, Gs^Fds, Gs^Fms, Gs^Qhh, Gs^Qhh, Gg^Qhh, Gg^Qhh, Gg^Qhh, Gg^Qhhf, Gg, Gg^Es, Re, Rb^Gvs, Re^Gvs, Re^Gvs, Re^Gvs, Re^Gvs, Gg^Eff, Gg^Eff, Gs, Gs^Fmw, Gs^Fds, Gs^Fds, Gs^Fds, Gs^Fds
Re^Gvs, Hh^Fds, Gs^Fms, Gs, Gg^Qhhf, Gs, Gs^Qhhf, Gs^Qhh, Gs^Fms, Gs^Fms, Gs^Fds, Gs^Fds, Gs^Fds, Gg, Gll, Re, Rb^Gvs, Gg, Gg, Re^Gvs, Gg, Gg^Eff, Gg^Fms, Gs, Gs^Fds, Gs^Fds, Gs^Fms, Gs, Hh, Hh
Re^Gvs, Re^Gvs, Gs^Qhh, Gg^Qhhf, Re^Gvs, Gg^Qhh, Rb^Gvs, Re^Gvs, Rb^Gvs, Gs^Fp, Rr, Gs^Fds, Gs^Fms, Gll, Rb^Gvs, Rb^Gvs, Re^Gvs, Re^Gvs, Re^Gvs, Gg, Gs^Fds, Gg, Gs^Fds, Gs^Fds, Gs^Fp, Gs^Fds, Gs^Fms, Hh^Fmw, Hh, Hh
Re^Gvs, Re^Gvs, Re^Gvs, Re^Gvs, Re^Gvs, Re^Gvs, Rb^Gvs, Rb^Gvs, Rb^Gvs, Gs, Gs, Gs, Re, Gll, Rb^Gvs, Rb^Gvs, Re^Gvs, Re^Gvs, Gg, Gg, Gg, Gg^Efm, Gg^Efm, Gs, Gs, Gs, Gs^Fms, Gs^Fmw, Hh^Fmw, Hh
Re^Gvs, Re^Gvs, Rb^Gvs, Re^Gvs, Rb^Gvs, Rb^Gvs, Rb^Gvs, Rb^Gvs, Gg^Vh, Gg^Efm, Gg^Efm, Re, Gs, Rb^Gvs, Rb^Gvs, Rb^Gvs, Re^Gvs, Re^Gvs, Gs^Fms, Gs^Fds, Gs^Fds, Gg, Gs^Fms, Gs, Gs^Fp, Gs^Fds, Gs^Fp, Gs^Fms, Hh^Fds, Hh^Fds
Hh^Fds, Re^Gvs, Hh, Rb^Gvs, Hh, Rb^Gvs, Rb^Gvs, Rb^Gvs, Re, Re, Gg, Re, Gg^Vl, Re^Gvs, Re^Gvs, Rb^Gvs, Gg^Eff, Gg^Eff, Gs^Fms, Gs^Fds, Gs^Fms, Gg^Efm, Gs^Fms, Gs^Fds, Gs^Fms, Gs^Fms, Gs, Gs^Fds, Gs^Qhhf, Gs^Qhhf
Hh^Fds, Hh^Fds, Hh^Qhh, Hh^Qhh, Hh^Qhh, Hh^Qhh, Gs, Gs, Ww^Ewl, Re, Re^Es, Re, Gg, Gg^Eff, Gs^Eff, Gs^Eff, Gs, Gs^Fms, Gs^Fds, Gs^Fds, Gg^Efm, Gg^Efm, Gs^Fp, Gs^Fds, Gs^Fms, Gs^Fms, Hh^Qhhf, Hh^Qhhf, Mm^Qhh, Hh^Qhh
Hh^Qhh, Hh^Qhh, Ww, Ww, Ww, Gg^Efm, Ww, Ww, Ch, Ch, Ch, Gg, Gg^Efm, Gs, Gg^Efm, Gs, Gs, Gs, Ww, Ww, Ww, Gs^Fds, Hh^Qhhf, Hh^Qhhf, Hh^Qhhf, Hh^Qhh, Hh^Qhh, Hh^Qhh, Mm^Qhh, Mm^Qhh
Hh^Qhh, Ww, Gs, Gs, Ww, Ww, Ww, Ww, Ww, Kh, Wwf, Ww, Ww, Gg^Efm, Gs, Gs^Efm, Ww, Ww, Gs^Fms, Gs^Fmw, Ww, Ww, Gg, Hh^Qhh, Hh^Qhhf, Hh^Qhh, Hh^Qhh, Mm^Qhh, Hh^Qhh, Mm^Qhh
Ww, Ww, Gs^Fds, Gs, Gg, Gs, Gg, Gs, Gs, Wwf, Re, Gs, Ww^Ewf, Ww, Ch, Gs, Ww, Gs^Fms, Gs^Fds, Gs^Fds, Gs^Fmw, Ww, Gs^Fds, Gs^Fmw, Ww, Ww, Ww, Hh^Qhh, Hh^Qhh, Hh^Qhh
Gs^Fms, Gs^Fms, Gs^Fds, Gs^Fds, Gg, Gg, Gg, Gg, Gg^Vhr, Re, Re, Re, Gs, Ww, Ww, Ww, Rb^Gvs, Gs^Fms, Gs, Gs, Gs^Fp, Ww, Ww, Wo, Ww, Hh^Qhh, Hh^Qhh, Wo, Wo, Hh^Qhh
Gs^Fds, Gs^Fms, Gs^Fds, Gs^Fds, Gg, Gg, Gg, Gg, Re, Re, Re, Gs, Hh, Gs, Re^Gvs, Rb^Gvs, Re^Gvs, Rb^Gvs, Re^Gvs, Gs^Fp, Gs^Fms, Gs^Fms, Gs, Ww, Ww^Ewl, Hh, Hh^Qhh, Ww, Hh^Qhh, Hh^Qhh
Gs^Fds, Gs^Fds, Gs^Fms, Gs^Fds, Re, Gg, Gll, Gg^Vhr, Gg, Gg, Re, Gs^Fds, Hh, Hh, Re^Gvs, Re^Gvs, Re^Gvs, Re^Gvs, Re^Gvs, Re^Gvs, Gs^Eff, Gs^Fmw, Gs, Ww^Ewf, Gs, Ww^Ewl, Ww, Ww, Hh^Qhh, Hh^Qhh
Gs^Fms, Gs^Fms, Re, Re, Gs^Qhuf, Gll, Gll^Es, Gs^Fms, Gg, Gg, Re, Hh^Es, Hh^Vhh, Gs, Gs, Re^Gvs, Re^Gvs, Re^Gvs, Gs^Eff, Gs^Eff, Hh^Fdw, Gs, Hh^Qhh, Gs, Gs^Fdw, Gs, Gs^Fms, Ww, Ww, Hh^Qhh
Re, Gs^Fds, Gll, Gs^Qhuf, Gs^Fds, Gs^Qhuf, Gs^Qhuf, Gs^Qhuf, Gg^Fmw, Hh^Fdw, Re, Gs, Gs, Gs, Gs^Fds, Gs^Eff, Gs^Eff, Gs^Eff, Hh, Gs^Qhh, Hh^Qhh, Hh^Qhh, Hh^Qhh, Gs, Gs, Gs, Hh^Fp, Ww, Hh^Qhh, Ww
Gll^Em, Re, Gll^Qhuf, Gs^Qhuf, Gs^Fms, Re, Gs^Fds, Gs^Qhuf, Gg, Gs^Fds, Hh^Fdw, Gs, Gs, Gs, Gs^Fds, Gs^Fds, Hh^Fp, Hh, Hh^Qhh, Hh^Qhh, Hh, Hh^Fdw, Hh, Hh^Qhh, Hh^Qhhf, Gs^Fp, Ww, Ww, Hh^Qhh, Hh^Qhh
Gs^Qhuf, Gs^Qhuf, Gs^Fds, Gll^_ml, Gs^Fds, Gs^Fds, Gs^Fds, Gs^Qhuf, Gs^Fmw, Gg, Gs, Re, Gs, Gs^Fms, Gs^Fds, Gs^Fds, Gs^Fp, Hh^Qhhf, Hh^Fp, Hh, Hh^Qhh, Hh^Qhh, Mm, Hh^Qhh, Hh, Hh^Qhhf, Hh^Qhh, Ww, Hh^Qhh, Ww
Gs^Qhuf, Gs^Fds, Gs^Fds, Gs^Fds, Gs^Fds, Gs^Fds, Gs^Fds, Gs^Qhuf, Gs^Qhuf, Gs, Re, Re, Re, Gs^Fp, Re, Gs^Fds, Hh^Qhhf, Hh^Qhhf, Hh^_mh, Hh^Fp, Hh^Qhh, Mm, Mm^Qhh, Mm^Qhh, Mm, Hh, Mm^Qhh, Ww, Ww, Ww
Hh^Qhuf, Gs^Fds, Gll^Fdw, Gs^Fds, Gll^Fp, Gs^Fds, Gs^Qhuf, Gs^Qhuf, Gs, Re^Es, Gs^Fmw, Gs, Gs^Fms, Re, Gs^Fms, Cer, Ker, Hh^Qhhf, Hh^Qhhf, Hh^Qhh, Hh^Qhh, Hh, Hh, Hh, Mm, Mm, Hh, Mm^Qhh, Ww, Ww
Gg^Qhu, Gll^Fmw, Gll^Fmw, Gll^Fmw, Gs^Fp, Gs^Fms, Gs^Qhuf, Gs^Fms, Gs, Re, Gs, Hh, Hh, Gs^Fds, Gs^Fms, Cer, Cer, Gs^Fms, Gs^Fdw, Gs^Fmw, Hh^Qhh, Hh^Fdw, Hh^Qhh, Hh^Qhh, Hh^Fdw, Hh^Es, Hh^Qhh, Hh^Qhh, Ww, Ww
Gs^Qhuf, Gs^Fp, Hh, Hh, Gll^Fmw, Gs^Fms, Gs^Qhuf, Gs, Gs^Fms, Re, Re, Gs^Fp, Gs^Fp, Gs^Fds, Gs, Gs, Gs^Fds, Gs^Fms, Gs^Fms, Gs^Fmw, Gs^Fp, Hh^Qhh, Hh^Fmw, Hh^Fmw, Ww, Hh^Fmw, Hh^Qhh, Ww, Ww, Gll^Fmw
Hh^Qhuf, Gs^Fms, Gs^Fds, Hh, Gll^Emf, Gs^Fmw, Gs^Fms, Gs^Qhuf, Gs^Fmw, Gs, Re, Gs^Fms, Gs^Fms, Gs^Fds, Gs^Fp, Gs^Fms, Gs^Fms, Gs, Gs^Fds, Gs^Fp, Gs^Fms, Hh^Fmw, Hh^Fms, Hh^Fp, Ww^Ewf, Ww, Hh^Qhh, Ww, Gll^Fmw, Gll^Fmw
Hh^Qhuf, Gs^Qhuf, Gll^Qhu, Gs^Qhu, Hh^Qhu, Gs^Qhuf, Gs^Qhuf, Gs^Qhuf, Gs, Re, Gs^Fmw, Re, Re^Es, Gs^Fms, Gg, Gs^Fds, Gg, Gs^Fms, Re^Es, Gs^Fms, Gs^Fdw, Hh, Gll^Fms, Gll^Fp, Gg, Gg^Qhhf, Ww, Ww, Gll^Em, Gs^Fp
