Hh^Qhhf, Hh^Qhhf, Hh^Qhhf, Hh^Qhhf, Hh^Qhhf, Hh^Qhhf, Hh^Qhhf, Gg^Qhhf, Gs^Qhhf, Gg^Qhhf, Gg^Qhhf, Gg^Qhhf, Gg^Qhhf, Gg^Qhhf, Gs^Qhhf, Gg^Qhhf, Gg, Re, Rb^Gvs, Rb^Gvs, Rb^Gvs, Re^Gvs, Re^Gvs, Re^Gvs, Gs^Fmw, Gs^Fmw, Gs^Fms, Gs^Fds, Gs^Fms, Gs^Fds
Hh, Hh, Hh, Hh^Fds, Hh^Fds, Hh^Fp, Hh^Fds, Gs^Fms, Gs^Fms, Gg^Fds, Gs^Fms, Gg^Efm, Gg^_mh, Gs^Fds, Gs^Qhhf, Gg, Re, 1 Re, Rb^Gvs, Rb^Gvs, Re^Wm, Re^Gvs, Re^Gvs, Gg^Eff, Gg^Eff, Gs^Fmw, Gs^Fms, Gs^Fmw, Gs^Fms, Gs^Fds
Hh, Hh, Hh^Fds, Hh, Gs, Gs, Gs^Fds, Gs^Fms, Gs^Qhh, Gs^Qhh, Gg^Qhh, Gg^Qhh, Gg^Qhh, Gg^Qhhf, Gg, Gg, Re, Rb^Gvs, Re^Gvs, Re^Gvs, Re^Gvs, Re^Gvs, Gg^Eff, Gg^Eff, Gs, Gs^Fmw, Gs^Fds, Gs^Fds, Gs^Fds, Gs^Fds
Re^Gvs, Hh^Fds, Gs^Fms, Gs, Gg^Qhhf, Gs, Gs^Qhhf, Gs^Qhh, Gs^Fms, Gs^Fms, Gs^Fds, Gs^Fms, Gg, Gg, Gll, Re, Rb^Gvs, Gg, Gg, Re^Gvs, Gg, Gg^Eff, Gg^Fms, Gs, Gs^Fds, Gs^Fds, Gs^Fms, Gs, Hh, Hh
Re^Gvs, Re^Gvs, Gs^Qhh, Gg^Qhhf, Re^Gvs, Gg^Qhh, Rb^Gvs, Re^Gvs, Gs, Gs^Fp, Gs^Fds, Gs^Fms, Gs, Gll, Rb^Gvs, Rb^Gvs, Re^Gvs, Re^Gvs, Re^Gvs, Gg, Gs^Fds, Gg, Gs^Fds, Gs^Fds, Gs^Fp, Gs^Fds, Gs^Fms, Hh^Fmw, Hh, Hh
Re^Gvs, Re^Gvs, Re^Gvs, Re^Gvs, Re^Gvs, Re^Gvs, Rb^Gvs, Rb^Gvs, Gs, Gs^Fds, Gs^Fds, Gs^Fds, Re, Gll, Rb^Gvs, Rb^Gvs, Re^Gvs, Re^Gvs, Gg, Gg, Gg, Gg^Efm, Gg^Efm, Gs, Gs, Gs, Gs^Fms, Gs^Fmw, Hh^Fmw, Hh
Re^Gvs, Re^Gvs, Rb^Gvs, Re^Gvs, Rb^Gvs, Rb^Gvs, Rb^Gvs, Rb^Gvs, Gg^Vh, Gg^Efm, Gg^Efm, Re, Gs, Rb^Gvs, Rb^Gvs, Rb^Gvs, Re^Gvs, Re^Gvs, Gs^Fms, Gs^Fds, Gs^Fds, Gg, Gs^Fms, Gs, Gs^Fp, Gs^Fds, Gs^Fp, Gs^Fms, Hh^Fds, Hh^Fds
Hh^Fds, Re^Gvs, Hh, Rb^Gvs, Hh, Rb^Gvs, Rb^Gvs, Rb^Gvs, Re, Re, Gg, Re, Gg^Vh, Re^Gvs, Re^Gvs, Rb^Gvs, Gg^Eff, Gg^Eff, Gs^Fms, Gs^Fds, Gs^Fms, Gg^Efm, Gs^Fms, Gs^Fds, Gs^Fms, Gs^Fms, Gs, Gs^Fds, Gs^Qhhf, Gs^Qhhf
Hh^Fds, Hh^Fds, Hh^Qhh, Hh^Qhh, Hh^Qhh, Hh^Qhh, Gs, Gs, Ww^Ewl, Re, Re^Es, Re, Gg, Gg^Eff, Gs^Eff, Gs^Eff, Gg, Gs^Fms, Gs^Fds, Gs^Fds, Gg^Vl, Gg^Efm, Gs^Fp, Gs^Fds, Gs^Fms, Gs^Fms, Hh^Qhhf, Hh^Qhhf, Mm^Qhh, Hh^Qhh
Hh^Qhh, Hh^Qhh, Ww, Ww, Ww, Gg^Efm, Ww, Ww, Ch, Ch, Ch, Gg, Ww, Gs, Gs, Ww^Ewf, Ww, Ww, Ww, Ww, Ww, Gs^Fds, Hh^Qhhf, Hh^Qhhf, Hh^Qhhf, Hh^Qhh, Hh^Qhh, Hh^Qhh, Mm^Qhh, Mm^Qhh
Hh^Qhh, Ww, Gs, Gs, Ww, Ww, Ww, Ww, Ww, Kh, Wwf, Ww, Gd, Ww, Ww, Ww, Ww, Ww, Gs^Fms, Gs^Fmw, Ww, Ww, Gg, Hh^Qhh, Hh^Qhhf, Hh^Qhh, Hh^Qhh, Mm^Qhh, Hh^Qhh, Mm^Qhh
Ww, Ww, Gs^Fds, Gs, Gg^Efm, Gs, Gg, Gs, Gs, Wwf, Re, Gd^Es, Gd, Gd, Rb^Gvs, Rb^Gvs, Rb^Gvs, Gs^Fms, Gs^Fds, Gs^Fp, Gs^Fmw, Ww, Gs^Fds, Gs^Fmw, Ww, Ww, Ww, Hh^Qhh, Hh^Qhh, Hh^Qhh
Gs^Fms, Gs^Fms, Gs^Fds, Gs^Fds, Gg^Efm, Gg, Gg, Gg, Gg, Re, Re, Gd^Vhr, Re^Gvs, Rb^Gvs, Rb^Gvs, Rb^Gvs, Rb^Gvs, Gs^Fms, Gg^Vl, Gs^Fds, Gs^Fp, Ww, Ww, Ww, Ww, Hh^Qhh, Hh^Qhh, Ww, Ww, Ww
Gs^Fds, Gs^Fms, Gs^Fds, Gs^Fds, Gg, Gg^Efm, Gg^Efm, Gg, Re, Re, Re, Gs, Hh, Re^Gvs, Re^Gvs, Rb^Gvs, Re^Gvs, Rb^Gvs, Gg^Fmw, Gs^Fp, Gs^Fms, Gs^Fms, Gs, Ww, Gd^Edpp, Hh, Hh^Qhh, Ww^Ewl, Ww, Ww
Gs^Fds, Gs^Fds, Gs^Fms, Gs^Fds, Re, Gg, Gll^Es, Gll, Gg, Gg^Vhr, Re, Gs^Fds, Hh, Hh, Re^Gvs, Re^Gvs, Re^Gvs, Re^Gvs, Gs^Eff, Gs^Eff, Gll, Gs^Fmw, Gs, Ww^Ewf, Gs, Gs, Gd, Gd^Edpp, Hh^Qhh, Ww
Gs^Fms, Gs^Fms, Re, Re, Gs^Fds, Gll, Gll^Em, Gs^Fms, Gg, Gg^Efm, Re, Hh^Es, Hh^Fdw, Gs^Vhr, Gg^Efm, Gs^Eff, Gs^Eff, Gs^Eff, Gs, Gs, Hh^Fdw, Gs, Hh^Qhh, Gs, Gs^Fdw, Gs, Gs^Vhr, Gs, Gd, Hh^Qhh
Re, Gs^Fds, Gll, Gs^Fds, Gs^Fds, Gs^Fds, Gs^Fds, Gs^Fds, Gg^Fmw, Hh^Fdw, Re, Gg, Gg^Em, Gg, Gs^Fds, Gg, Hh, Gs^Fms, Hh, Gs^Qhh, Hh^Qhh, Hh^Qhh, Hh^Qhh, Gs, Gs, Gs^Fms, Hh^Fp, Hh, Hh^Qhh, Gd
Gll^Em, Re, Gll^Fmw, Gs^Fms, Gs^Fms, Re, Gs^Fds, Gs^Fds, Gs^Efm, Gs^Fds, Hh^Fdw, Re, Gs, Gg^Efm, Gs^Fds, Gs^Fds, Hh^Fp, Hh, Hh^Qhh, Hh^Qhh, Hh, Hh^Fdw, Hh, Hh^Qhh, Hh^Qhhf, Gs^Fp, Gll^Emf, Hh^Fmw, Hh^Qhh, Hh^Qhh
Gs^Fds, Gs^Fds, Gs^Fds, Gll^Em, Gs^Fds, Gs^Fds, Gs^Fds, Gs^Fds, Gs^Fmw, Gg, Gg, Re, Gs, Gs^Fms, Ce, Gs^Fds, Ce, Hh^Qhhf, Hh^Fp, Hh, Hh^Qhh, Hh^Qhh, Mm, Hh^Qhh, Hh, Hh^Qhhf, Hh^Qhh, Hh^Qhh, Hh^Es, Hh^Qhh
Gs^Fds, Gs^Fds, Gs^Fds, Gs^Fds, Gs^Fds, Gs^Fds, Gs^Fds, Gs^Fms, Gs^Fmw, Gs, Re, Re, Re, Gs^Fp, Ce, 2 Ke, Hh^Qhhf, Hh^Qhhf, Hh^_mh, Hh^Fp, Hh^Qhh, Mm, Mm^Qhh, Mm^Qhh, Mm, Hh, Mm, Hh, Hh^Fdw, Hh^Qhh
Hh, Gs^Fds, Gll^Fdw, Gs^Fds, Gll^Fp, Gs^Fds, Gs^Fms, Gs^Fms, Gs, Re^Es, Gs^Fmw, Gs^Fp, Gs^Fms, Re, Gs^Fms, Ce, Re^Es, Hh^Qhhf, Hh^Qhhf, Hh^Qhh, Hh^Qhh, Hh, Hh, Hh, Mm, Mm, Hh, Mm, Mm, Hh^Qhh
Gg, Gll^Fmw, Gll^Fmw, Gll^Fmw, Gs^Fp, Gs^Fms, Gs^Fmw, Gs^Fms, Gs, Re, Gs, Hh, Hh, Gs^Fms, Gs^Fms, Gs^Fds, Gs^Fms, Gs^Fp, Gs^Fdw, Gs^Fmw, Hh^Qhh, Hh^Fdw, Hh^Qhh, Hh^Qhh, Hh^Fdw, Hh^Es, Hh^Fdw, Hh, Hh, Mm^Qhh
Gs^Fp, Gs^Fp, Hh, Hh, Gll^Fmw, Gs^Fms, Gs^Fms, Gg^Vl, Gs^Fms, Re, Re, Gs^Fp, Gs^Fp, Gs^Fds, Gs, Gs, Gs^Fds, Gs^Fms, Gs^Fms, Gs^Fmw, Gs^Fp, Hh^Qhh, Hh^Fmw, Hh^Fmw, Ww, Hh^Fmw, Hh^Fds, Hh, Hh^Fdw, Hh^Qhh
Hh^Fms, Gs^Fms, Gs^Fds, Hh, Gll^Emf, Gs^Fmw, Gs^Fms, Gs^Fms, Gs^Fmw, Gs, Re, Gs^Fms, Gs^Fms, Gs^Fds, Gs^Fp, Gs^Fms, Gs^Fms, Gs, Gs^Fds, Gs^Fp, Gs^Fms, Hh^Fmw, Hh^Fms, Hh^Fp, Ww^Ewf, Ww, Gll^Fp, Hh, Gll^Fmw, Gll^Fmw
Hh^Fmw, Gs^Fms, Gll^Em, Gs, Hh, Gs^Fms, Gs^Fmw, Gs^Fmw, Gs, Re, Gs^Fmw, Re, Re^Es, Gs^Fms, Gg, Gs^Fds, Gg, Gs^Fms, Re^Es, Gs^Fms, Gs^Fdw, Hh, Gll^Fms, Gll^Fp, Gg, Gg, Gll^Fp, Gs^Fp, Gll^Em, Gs^Fp
