Hh^Qhhf, Hh^Qhhf, Hh^Qhhf, Hh^Qhhf, Hh^Qhhf, Hh^Qhhf, Hh^Qhhf, Gg^Qhhf, Gs^Qhhf, Gg^Qhhf, Gg^Qhhf, Gg^Qhhf, Gg^Qhhf, Gg^Qhhf, Gs^Qhhf, Gg^Qhhf, Gg, Re, Rb^Gvs, Rb^Gvs, Rb^Gvs, Re^Gvs, Re^Gvs, Re^Gvs, Gs^Fmw, Gs^Fmw, Gs^Fms, Gs^Fds, Gs^Fms, Gs^Fds
Hh, Hh, Hh, Hh^Fds, Hh^Fds, Hh^Fp, Hh^Fds, Gs^Fms, Gs^Fms, Gg^Fds, Gs^Fms, Gg^Efm, Gg^_mh, Gs^Fds, Gs^Qhhf, Gg, Re, 1 Re, Rb^Gvs, Rb^Gvs, Re^Wm, Re^Gvs, Re^Gvs, Gg^Eff, Gg^Eff, Gs^Fmw, Gs^Fms, Gs^Fmw, Gs^Fms, Gs^Fds
Hh, Hh, Hh^Fds, Hh, Gs, Gs, Gs^Fds, Gs^Fms, Gs^Qhh, Gs^Qhh, Gg^Qhh, Gg^Qhh, Gg^Qhh, Gg^Qhhf, Gg, Gg^Es, Re, Rb^Gvs, Re^Gvs, Re^Gvs, Re^Gvs, Re^Gvs, Gg^Eff, Gg^Eff, Gs, Gs^Fmw, Gs^Fds, Gs^Fds, Gs^Fds, Gs^Fds
Re^Gvs, Hh^Fds, Gs^Fms, Gs, Gg^Qhhf, Gs, Gs^Qhhf, Gs^Qhh, Gs^Fms, Gs^Fms, Gs^Fds, Gs^Fds, Gs^Fds, Gg, Gll, Re, Rb^Gvs, Gg, Gg, Re^Gvs, Gg, Gg^Eff, Gg^Fms, Gs, Gs^Fds, Gs^Fds, Gs^Fms, Gs, Hh, Hh
Re^Gvs, Re^Gvs, Gs^Qhh, Gg^Qhhf, Re^Gvs, Gg^Qhh, Rb^Gvs, Re^Gvs, Rb^Gvs, Gs^Fp, Hh, Gs^Fds, Gs, Gll, Rb^Gvs, Rb^Gvs, Re^Gvs, Re^Gvs, Re^Gvs, Gg, Gs^Fds, Gg, Gs^Fds, Gs^Fds, Gs^Fp, Gs^Fds, Gs^Fms, Hh^Fmw, Hh, Hh
Re^Gvs, Re^Gvs, Re^Gvs, Re^Gvs, Re^Gvs, Re^Gvs, Rb^Gvs, Rb^Gvs, Rb^Gvs, Gs, Gs, Gs, Re, Gll, Rb^Gvs, Rb^Gvs, Re^Gvs, Re^Gvs, Gg, Gg, Gg, Gg^Efm, Gg^Efm, Gs, Gs, Gs, Gs^Fms, Gs^Fmw, Hh^Fmw, Hh
Re^Gvs, Re^Gvs, Rb^Gvs, Re^Gvs, Rb^Gvs, Rb^Gvs, Rb^Gvs, Rb^Gvs, Gg^Vh, Gg^Efm, Gg^Efm, Re, Gs, Rb^Gvs, Rb^Gvs, Rb^Gvs, Re^Gvs, Re^Gvs, Gs^Fms, Gs^Fds, Gs^Fds, Gg, Gs^Fms, Gs, Gs^Fp, Gs^Fds, Gs^Fp, Gs^Fms, Hh^Fds, Hh^Fds
Hh^Fds, Re^Gvs, Hh, Rb^Gvs, Hh, Rb^Gvs, Rb^Gvs, Rb^Gvs, Re, Re, Gg, Re, Gg^Vh, Re^Gvs, Re^Gvs, Rb^Gvs, Gg^Eff, Gg^Eff, Gs^Fms, Gs^Fds, Gs^Fms, Gg^Efm, Gs^Fms, Gs^Fds, Gs^Fms, Gs^Fms, Gs, Gs^Fds, Gs^Qhhf, Gs^Qhhf
Hh^Fds, Hh^Fds, Hh^Qhh, Hh^Qhh, Hh^Qhh, Hh^Qhh, Gs, Gs, Ww^Ewl, Re, Re^Es, Re, Gg, Gg^Eff, Gs^Eff, Gs^Eff, Gg, Gs^Fms, Gs^Fds, Gs^Fds, Gg^Vl, Gg^Efm, Gs^Fp, Gs^Fds, Gs^Fms, Gs^Fms, Hh^Qhhf, Hh^Qhhf, Mm^Qhh, Hh^Qhh
Hh^Qhh, Hh^Qhh, Ww, Ww, Ww, Gg^Efm, Ww, Ww, Ch, Ch, Ch, Gg, Ww, Gs, Gs, Ww^Ewf, Ww, Ww, Ww, Ww, Ww, Gs^Fds, Hh^Qhhf, Hh^Qhhf, Hh^Qhhf, Hh^Qhh, Hh^Qhh, Hh^Qhh, Mm^Qhh, Mm^Qhh
Hh^Qhh, Ww, Gs, Gs, Ww, Ww, Ww, Ww, Ww, Kh, Wwf, Ww, Gd, Ww, Ww, Ww, Ww, Ww, Gs^Fms, Gs^Fmw, Ww, Ww, Gg, Hh^Qhh, Hh^Qhhf, Hh^Qhh, Hh^Qhh, Mm^Qhh, Hh^Qhh, Mm^Qhh
Ww, Ww, Gs^Fds, Gs, Gg^Efm, Gs, Gg, Gs, Gs, Wwf, Re, Gd^Es, Gd, Gd, Rb^Gvs, Rb^Gvs, Rb^Gvs, Gs^Fms, Gs^Fds, Gs^Fp, Gs^Fmw, Ww, Gs^Fds, Gs^Fmw, Ww, Ww, Ww, Hh^Qhh, Hh^Qhh, Hh^Qhh
