Ss^Em, Ss, Hh^Es, Sm^Edb, Hh^Em, Sm^Em, Rb^Fdw, Gll^Fmw, Gll^Fmw, Re, Re, Gs, Gd^Fdw, Gs^Fmw, Gd^Es, Ww, Ww, Ww, Ds^Esd, Ds, Rd, Gd, Re^Gvs, Gd^Eff, Gd^Eff, Gs, Re, Gs, Re, Rr^Es, Gg, Rr, Gg^Efm
Ss^Em, Hh^Fdw, Sm^Em, Hh^Es, Hh^Fmw, Gll^Emf, Hh^Fmw, Hh, Gs^Fmw, Gd, Gd, Re^Es, Gd, Ce, Ww, Ww, Wo, Ww, Ds, Ds, Rd, Re^Gvs, Re^Es, Re^Wm, Re^Gvs, Gs^Eff, Gs, Re, 1 Re, Gg, Gg, Gs, Gg
Rb^Fdw, Sm, Ss^Edb, Hh^Fmw, Gs^Fmw, Hh^Fmw, Gd^Fmw, Gs^Fp, Gs^Fmw, Ce, Gd, Re, Gs, Gs^Vh, Ww, Wo, Wwr, Ww, Ds^Esd, Rd, Gd, Re^Es, Re^Gvs, Re^Gvs, Gd, Ce, Gg^Efm, Gg^Efm, Gs, Re, Gs^Em, Gg^Efm, Gs^Fp
Gs^Fmw, Gd^Fp, Gs^Em, Gd^Fmw, Gs^Eff, Gs^Eff, Gd^Eff, Gs^Em, Gs^Eff, Gs^Eff, Gs^Fmw, Re, Re, Ww, Ww, Wo, Wwr, Ww, Ww, Ds, Ds, Gd, Rd, Rd, Rr, Gg^Es, Rp, Gs, Re, Re, Gll, Gs, Gs
Gs^Fmw, Gd^Em, Ce, Gs, Re^Gvs, Re^Gvs, Re, Gd, Gg, Gg^Es, Gg, Re, Re, Ww, Ch, Ww, Ww, Ww, Ww, Ww, Ww, Ch, Rr^Es, Rr, Gs, Rr^Es, Ce, Re, Gs, Gs^Em, Gs^Fms, Gs^Fms, Gs^Fms
Gg, Gg^Em, Gs, Re, Gs^Fp, Re, Gs^Em, Gg, Gg^Efm, Gg, Gs, Gs, Re, Re, Ch, Rr, Rr, Ww^Ewf, Ww^Ewl, Wwr, Ww^Bw/, Rr, Gg, Gs, Re^Gvs, Re^Gvs, Re^Gvs, Gll^Fdw, Gs^Fp, Gll^Em, Gll^Fp, Gs^Fms, Gs^Fds
Gll, Gg, Gg, Gs, Gg, Gs^Vh, Gg, Gs^Fmw, Gg, Gg, Gg, Gs, Rr^Vh, Re^Es, Rr, Ch, Ch, Ch, Rr, Ww^Bw/, Ww^Ewf, Ww^Ewl, Ww, Gs^Eff, Gd^Eff, Re^Gvs, Gs^Eff, Gs^Fdw, Gs^Fms, Gll^Fp, Gll^Fp, Gs^Fds, Gs^Fds
Gll^Fdw, Gg^Es, Gg, Gg^Efm, Gg, Gg^Em, Gg, Gg, Re^Gvs, Gs, Re, Re^Gvs, Ch, Rr, Rr, Rr, Rr^Es, Rr, Ch, Rr^Vhc, Ww^Ewl, Wo, Wo, Ww, Ww, Gd^Eff, Gs^Fmw, Gs^Fmw, Gll^Em, Gll^Fms, Gll^Fp, Gs^Fms, Hh^Fms
Gll^Fp, Gs^Efm, Gs^Fms, Gs^Fms, Gd^Es, Re^Gvs, Re^Gvs, Re^Gvs, Re, Re, Re^Gvs, Re^Gvs, Ch, Rr, Rr, Rr, Rr^Es, Rr^Vhc, Ch^Ebn, Ch, 2 Kh, Wo, Wo, Wo, Ww, Ww, Gs^Es, Gs^Em, Gs^Fp, Gll^Fp, Hh, Hh^Fmw, Hh^Fms
Gll^Fp, Gll^Fp, Ce, Gd, Gd^Es, Gs^Es, Re^Wm, Re^Es, Re^Eff, Re, Re^Gvs, Re^Gvs, Re^Gvs, Ch, Rr, Rr, Rr, Rr, Rr, Rr, Ch, Ww^Bw/, Wo, Wo, Wo, Ww, Gd^Fmw, Gs^Fms, Hh^Fms, Gll^Emf, Mm, Hh^Fmw, Mm
Gs^Fp, Gs, Ce, Gll, Re^Gvs, Re^Gvs, Re^Gvs, Re^Gvs, Gs^Eff, Re^Eff, Re^Gvs, Re^Gvs, Gs^Vh, Gs, Re, Rr, Rr^Vhc, Rr, Rr, Ch^Ebn, Ch, Ww^Bw/, Wo, Wo, Ww, Ww, Ww, Hh, Hh, Hh, Hh^Fdw, Hh, Hh
Gs, Gs, Ce, Re, Re^Es, Re^Gvs, Gd^Eff, Gs^Eff, Re, Re, Gs, Gd, Gs^Es, Re, Re, Ch, Rr, Rr, Rr^Vhc, Rr^Vhc, Ww^Ewf, Ww^Ewl, Wwr, Ww^Ewf, Ww, Ww^Ewl, Rd^Es, Gd, Hh, Mm, Mm, Mm, Hh
Gs, Re^Es, Re, Ce, Ce, Gs, Gs, Re^Es, Re, Gd, Gd^Es, Gd, Re, Re, Re, Rr, Re, Ch, Ch, Ch, Ww, Ww, Ww, Ww, Rd^Es, Hh, Hh, Hh, Mm, Mm, Mm, Mm, Wo
Gs^Em, Re, Re^Es, Gs^Fp, Re, Gs^Vc, Gs^Eff, Re^Eff, Re, Gs, Re, Re, Rr^Es, Re^Es, Rr, Rr, Re, Re^Es, Re, Re, Gs, Ww, Ww, Ww, Ww, Rd^Es, Ww^Ewl, Mm, Mm, Mm, Mm, Mm, Hh^Fms
Gs^Em, Gs^Fms, Gs^Fp, Re^Es, Gll^Eff, Re^Eff, Re^Gvs, Re^Gvs, Re, Re, Re, Ch, Rr, Rr^Es, Rr, Re, Re, Re^Es, Re, Gd^Fdw, Gll^Fmw, Wwr, Gs^Fmw, Ww, Wo, Ww, Wo, Mm, Wo, Mm, Mm, Mm, Hh
Gll^Emf, Gs^Fms, Gs^Eff, Gll^Eff, Re^Gvs, Re^Gvs, Re^Gvs, Re^Gvs, Re^Gvs, Re, Gll^Fdw, Ch, Ch, Rr, Ch, Re, Re, Gg, Gg^Efm, Re, Gs^Vh, Gg^Fp, Wwr, Wwr, Ww, Wo, Wo, Wo, Wo, Mm, Mm, Gs^Fp, Ww
Gll^Fp, Gll^Fp, Gs^Fp, Gll^Eff, Re, Re^Gvs, Re^Vwm, Re^Gvs, Re, Re, Gs, Gll, Gs, Ch, Re^Es, Re, Re, Gd, Gs^Fmw, Gs, Gg^Fp, Ww, Ww, Ww, Ww, Ww, Wo, Wo, Mm, Mm, Mm, Wo, Wo
Gs^Fms, Gs^Fms, Wwf, Gll^Fp, Wwf, Ce, Gs^Fmw, Gs, Gs, Gs^Fmw, Gs^Fmw, Gll^Fdw, Wwf, Re^Es, Wwf, Re, Re, Gs, Ww, Gg^Em, Ww, Ww, Wo, Ww, Wo, Gs^Fdw, Gs^Fp, Wo, Wo, Mm, Wo, Wo, Gg^Efm
Ww^Ewl, Wwf, Ww, Ww, Ww, Wwf, Ww, Gll^Fdw, Wwf, Gll^Fmw, Gs, Wwf, Ww^Ewl, Wwf, Ww, Re^Es, Ch, Re, Ww^Bw\, Wo, Wo, Ww, Wo, Wo, Wo, Ww, Wo, Wo, Wo, Wo, Hh^Es, Wo, Gs^Fp
Ww, Wwf, Ww, Ww, Wwr, Ww, Ww, Ww, Ww, Wwf, Ww, Ww, Ww, Ww, Ww, Ww, Wo, Ww, Wo, Wo, Wo, Wo, Wo, Ww, Ww, Ww, Ww, Wo, Hh^Es, Hh, Hh^Fmw, Hh^Es, Gs^Fmw
Ww, Ww, Ww, Ww, Ww, Wwr, Wwr, Ww, Ww, Ww, Ww, Ww, Ww, Ww, Ww, Wo, Wo, Wo, Wo, Wo, Wo, Wo, Ww, Ww, Gs^Fp, Gll^Emf, Hh, Wo, Wo, Mm, Wo, Hh^Es, Hh^Fdw
Gll, Gll, Wwf, Wwr, Ww, Wwr, Ww^Ewl, Ww, Wwf, Ww, Gll, Re^Es, Wwf, Ww, Re^Es, Ww, Ww, Ww, Ww, Ww, Ww, Wo, Ww^Ewf, Ww, Ww, Hh^Fds, Hh^Es, Wo, Hh^Fdw, Wo, Mm, Wo, Mm
Gll, Gll, Gs^Fmw, Ww^Ewl, Hh, Gll, Gs^Fms, Gll, Gll, Wwf, Gll, Gd, Wwf, Wwr, Ss^Em, Gd, Ww, Ww, Ww, Ww, Ww, Wwr, Wwr, Wwr, Ww^Ewl, Hh^Fms, Mm, Mm, Mm, Mm, Mm, Mm, Mm
Gs^Fms, Gs^Fmw, Gs^Fp, Gs^Fmw, Hh, Gll^Fp, Gll^Fmw, Gll^Fmw, Hh^Es, Rb^Em, Rb^Em, Wwf^Em, Gll^Emf, Ww^Ewl, Rb^Em, Gd^Fdw, Gd, Ww, Wwf, Ww, Wwr, Wwr, Wwr, Wwr, Mm, Ww, Mm, Mm, Mm, Mm, Mm, Wo, Wo
Gs, Gs^Em, Gs^Fmw, Gll^Fp, Gll^Fdw, Gll^Fmw, Gll^Fp, Hh^Es, Gll^Fmw, Gll^Emf, Gll^Fp, Ss^Em, Ss^Edb, Ss^Em, Gll^Fmw, Re^Em, Gll^Fp, Gll^Fp, Gs^Fms, Ww, Ww^Ewl, Ww, Hh^Fp, Hh^Fds, Mm, Wo, Wo, Mm, Mm, Mm, Mm, Mm, Mm
