Rb^Gvs, Rb^Gvs, Rb^Gvs, Rb^Gvs, Rb^Gvs, Gg, Rb^Gvs, Gs^Qhh, Gg^Qhh, Gg^Qhh, Gg^Qhh, Gg^Qhh, Gg^Qhh, Gg^Qhh, Gg^Qhh, Wwf, Wwf, Ww, Ww^Ewf, Wwf, Wwf, Gs, Gs, Gs, Gs^Qhh, Gs^Qhh, Rb^Gvs, Rb^Gvs, Rb^Gvs, Rb^Gvs, Rb^Gvs, Gg^Qhh, Gg^Qhh, Gs^Qhh, Gs, Gs
Rb^Gvs, Rb^Gvs, Rb^Gvs, Rb^Gvs, Rb^Gvs, Rb^Gvs, Rb^Gvs, Gg^Es, Gs, Gg, Gs^Es, Gs, Gg^Fds, Gg^Qhhf, Ds, Wwf, Ww, Ww, Ww^Ewf, Ww^Ewf, Gg, Gg, Gg, Gs^Fds, Gs^Qhh, Re^Gvs, Re^Gvs, Re^Gvs, Rb^Gvs, Rb^Gvs, Rb^Qhh, Rb^Qhh, Rb^Qhh, Rb^Gvs, Rb^Gvs, Rb^Gvs
Rb^Gvs, Rb^Gvs, Rb^Gvs, Rb^Gvs, Rb^Gvs, Rb^Gvs, Gs^Es, Gs, Gs, Gg, Gs, Gs, Gs, Gs^Qhh, Ds, Wwf, Ww, Ww, Ww, Ww, Gg, Gg, Gs^Fds, Gs, Gs^Qhh, Re^Gvs, Rb^Gvs, Rb^Wm, Gs, Re^Gvs, Gg^Fds, Rb^Qhh, Rb^Gvs, Rb^Gvs, Rb^Gvs, Rb^Gvs
Rb^Gvs, Rb^Gvs, Rb^Gvs, Rb^Gvs, Gs^Eff, Gs^Eff, Gs, Gs, Gs, Gs, Gs, Gs, Gs^Qhh, Gs^Qhh, Wwf, Wwf, Wwf, Ww, Ww, Gs, Gs, Gs^Fds, Gs, Gs^Qhh, Re^_mh, Rb^Gvs, Rb^Gvs, Re^Gvs, Rb^Gvs, Gg^Fds, Gg, Rb^Gvs, Rb^Gvs, Rb^Gvs, Rb^Gvs, Rb^Gvs
Rb^Gvs, Rb^Gvs, Gs^Eff, Gs^Eff, Rb^Gvs, Gs^Eff, Gs^Vhr, Gs, Gs, Gg, Gs, Gs, Gs^Qhh, Wwf, Wwf, Wwf, Wwf, Ww, Wwf, Gs, Gs, Gs, Gg^Fms, Hh^Qhh, Hh^Qhh, Rb^Gvs, Gs^Qhh, Rb^Gvs, Rb^Gvs, Rb^Gvs, Gs^Eff, Rb^Gvs, Rb^Gvs, Rb^Gvs, Rb^Gvs, Rb^Gvs
Gs^Eff, Gs^Eff, Rb^Gvs, Rb^Gvs, Rb^Gvs, Gs, Gs, Gs, Gs, Gs, Gs^Qhh, Gs^Qhh, Wwf, Wwf, Ww, Wwf, Wwf, Wwf, Gs, Gs^Fms, Gs, Gs, Gs, Hh, Gg, Hh^Qhh, Gg^Fds, Gs^Qhh, Gg^Qhh, Rb^Gvs, Gs^Qhh, Gs^Eff, Gs^Eff, Re^Gvs, Gs^Eff, Re^Gvs
Rb^Gvs, Rb^Gvs, Rb^Gvs, Rb^Gvs, Rb^Gvs, Gs, Gs, Gs, Hh, Gs^Qhh, Ww, Wwf, Wwf, Wwf, Ww, Ww, Ww, Wwf, Wwf, Gs, Gs, Gs, Gs, Gs, Gs, Gg^Fds, Gg, Gg^Fms, Gg^Fds, Gg^Qhhf, Gg^Fds, Gs^Qhh, Gs^Qhh, Gs^Eff, Gs^Qhh, Gs^Eff
Rb^Gvs, Rb^Gvs, Rb^Gvs, Rb^Gvs, Gs^Vhr, Gs, Gs, Hh, Hh, Cer^Qhh, Ds, Ww, Hh, Hh, Cer^Qhu, Ww, Wwf, Wwf, Gs, Hh, Gg^Fms, Gg^Fms, Gs, Gg^Fms, Gg^Fds, Gs, Gs, Gg^Fms, Gg, Gg^Fds, Gg^Fds, Gg, Hh, Hh^Qhh, Hh, Re^Qhh
Re, Rb^Gvs, Gs, Gs, Re, Gs, Gs, Gs, Hh, Gs^Qhh, Ds, Wwf, Ww, Hh, Ww, Ww, Ww, Wwf, Hh^Vc, Hh, Hh, Gg^Fms, Re, Gs, Re, Re, Gg, Gg, Gg, Gg^Es, Rb^Es, Re, Gg, Hh, Gg, Re
Gg, Re, Re, Gg, Gg, Re, Gs, Gs, Gs, Gs^Qhh, Gs^Qhh, Hh^Qhh, Cer^Qhh, Ww, Wwf, Ww, Wwf, Hh, Gs^Es, Hh, Re, Re, Rb, Rb, Gs, Re, Rb, Gg, Re, Rb, Gg, Rb, Rb, Gg, Rb, Gg
Gs, Gg, Gg, Gg, Gg^Qhh, Gs, Gs^Qhh, Re, Re, Re^Qhh, Re, Re, Wwf, Ww, Wwf, Wwf, Re, Gs, Re, Gg, Gg, Gg, Gg, Gs, Re^Gvs, Gs^Vhr, Gg^Es, Gg, Gg, Gg, Re^Gvs, Gg, Gg, Gg, Gg, Gg
Gg, Gs, Gg^Qhh, Gg^Qhh, Gg^Fds, Gg^Qhh, Gg^Fds, Gs^Qhh, Gs^Qhh, Re, Hh^Qhh, Re, Wwf, Wwf, Wwf, Wwf, Gs, Re, Gs^Eff, Gs, Rb^Eff, Gg^Eff, Rb^Gvs, Re^Gvs, Rb^Gvs, Rb^Gvs, Re^Gvs, Gg, Re^Gvs, Re^Gvs, Rb^Gvs, Rb^Gvs, Rb^Gvs, Gg, Gg, Gg
Gg, Gg^Qhh, Gg^Fds, Gg^Fds, Gs, Gg^Fds, Gs^Edt, Gg^Fds, Gs^Qhh, Hh^Qhh, Cer^Qhh, Ww, Wwf, Wwf, Ww, Gs, Gs^Vhr, Gs^Eff, Rb^Gvs, Rb^Eff, Re^Gvs, Re, Re, Re, Gs^Eff, Rb^Gvs, Rb^Gvs, Re^Gvs, Rb^Gvs, Rb^Gvs, Rb^Gvs, Rb^Gvs, Rb^Gvs, Rb^Gvs, Rb^Gvs, Gg
Gg^Qhu, Gs, Gs, Gs, Gg^Fms, Gg^Fms, Cer^Qhh, Gs^Qhh, Ww, Hh^Qhh, Ww, Ww, Ww, Ww, Ww, Wwf, Rb^Gvs, Rb^Gvs, Rb^Gvs, Rb^Gvs, Re^Gvs, Re^Gvs, Re^Gvs, Gg, Gg, Gs^Eff, Rb^Eff, Rb^Gvs, Rb^Gvs, Rb^Gvs, Re^Gvs, Re^Gvs, Re^Gvs, Re^Gvs, Re^Gvs, Re^Gvs
Gg^Qhu, Gg^Qhu, Gg^Qhu, Gg, Re, Cer^Edt, 2 Ker^Qhh, Ww^Es, Ww, Ww, Ds, Ds, Ds^Ewsh, Ww, Ww, Ww, Gs, Rb^Gvs, Re^Gvs, Rb^Gvs, Re^Gvs, Re^Gvs, Re, Gg^Es, Gg^Eff, Gg^Eff, Gs^Eff, Rb^Gvs, Rb^Gvs, Rb^Gvs, Rb^Gvs, Rb^Gvs, Rb^Gvs, Rb^Gvs, Rb^Gvs, Rb^Gvs
Gg^Qhu, Gg^Efm, Gg^Efm, Gg^Qhu, Gg, Re, Cer^Edt, Cer^Qhh, Ww, Ww^Es, Ww, Ds, Ds, Ww, Ww, Ww, Gs, Gg, Gg, Re^Gvs, Rb^Gvs, Re, Re, Rb^Gvs, Rb^Gvs, Rb^Gvs, Rb^Gvs, Gg^Eff, Gg^Eff, Rb^Gvs, Rb^Gvs, Rb^Gvs, Rb^Gvs, Rb^Gvs, Rb^Gvs, Rb^Gvs
Gg^Qhu, Gg^_ml, Gs^Qhu, Gs^Qhu, Re, Rb^Edt, Rb^Edt, Rb^Qhh, Hh^Qhhf, Gg^Fms, Cer^Edt, Ww, Ww, Ww, Wwf, Ww, Ww^Es, Gs, Rb^Gvs, Rb^Gvs, Rb^Gvs, Gs^Vhr, Gs^Eff, Re^Gvs, Re^Gvs, Rb^Gvs, Rb^Gvs, Rb^Gvs, Rb^Gvs, Gs^Eff, Rb^Wm, Rb, Rb, Rb, Rb, Rb
Gg^Qhu, Gg^Qhu, Gg, Gg, Re^Es, Re^Ecf, Rb, Hh^_mh, Hh^Qhh, Gg^Fds, Ww, Ww, Ww, Ww, Wwf, Wwf, Gg, Rb^Gvs, Rb^Gvs, Rb^Gvs, Rb^Gvs, Rb^Gvs, Re^Eff, Rb^Eff, Re^Gvs, Rb^Gvs, Rb^Gvs, Rb^Gvs, Rb^Gvs, Rb^Gvs, Rb, Gs^Eff, Gs^Eff, Gs^Eff, Gs^Eff, Gs^Eff
Gs^Qhu, Gs^Qhu, Gs, Re^Qhh, Re^Qhh, Gg^Qhh, Gg^Qhh, Gg^Qhh, Hh^Qhh, Ww, Ww, Ww, Ww, Wwf, Wwf, Wwf, Gs, Re, Re, Rb^Gvs, Re, Rb^Eff, Re, Rb^Gvs, Rb^Gvs, Re^Gvs, Rb^Gvs, Rb^Gvs, Rb^Gvs, Rb^Gvs, Rb^Gvs, Rb, Rb, Rb, Rb, Rb
