Gs^Fds, Gs^Fds, Gs^Fms, Gs^Fms, Gs^Fms, Gs^Fms, Gs^Fds, Gs^Fds, Gg^Em, Gs^Fds, Gs^Fms, Gs^Fds, Gs^Fds, Gs^Fds, Hh^Fms, Hh^Fds, Gs^Fds, Gs^Fds, Gs^Fds, Gs^Fds, Hh^Fms, Hh, Hh, Hh, Gs^Es, Hh, Gll^Fmw, Ss, Sm^Em, Ss, Ss, Wwg, Ss, Sm, Ss, Ss, Ss, Sm, Gll^Fp, Wwg, Wwg, Gll^Fdw, Gll^Fmw, Gll^Fp, Gll^Fdw, Gll^Fp
Gg^Efm, Gs^Fms, Gs^Fds, Gg^Efm, Gs^Fms, Gs^Fms, Gs^Fms, Gg^Efm, Gg^Em, Gs^Fds, Gs^Fds, Gs^Fp, Gs^Fds, Gs^Fms, Gs^Fds, Hh, Gg^Em, Hh^Fds, Hh^Em, Hh^Fms, Hh^Fms, Hh^Fp, Hh^Es, Gs^Fp, Gll^Fmw, Gll^Em, Ss^Em, Sm^Em, Re^Em, Sm^Em, Sm, Wwg, Rb^Em, Sm^Em, Sm^Em, Ss^Emf, Ss, Gll^Fp, Gll^Emf, Re^Em, Wwg, Wwg, Gll^Emf, Gll^Fp, Gll^Emf, Gll^Fp
Gg^Em, Gs^Fds, Gs^Fms, Gs^Fms, Gs^Fms, Gs^Fms, Gg^Ve, Gs^Fds, Gg^Fp, Gs^Fms, Gg^Fds, Gs^Fds, Gg^Fms, Hh^Fp, Gg^Em, Hh^Fds, Gg^Efm, Hh^Em, Hh^Fds, Gs^Fms, Gs^Fms, Hh^Fms, Hh^Em, Hh^Em, Gll^Emf, Rb^Em, Ss^Emf, Gll^Fmw, Gll^Fp, Re^Em, Ss, Wwg^Ewl, Gll^Emf, Gll^Fp, Wwg^Ewl, Wwg^Ewl, Wwg, Sm, Wwg, Wwg, Wwg, Gll^Fp, Gll^Fp, Gll^Em, Gs^Fms, Gs^Fms
Rp, Gs^Fms, Gs^Fp, Gs^Fds, Gg^Fp, Gg^Efm, Gg^Em, Gs^Fds, Gg^Fms, Gg^Fms, Gg^Fms, Gg^Fms, Gg^Fds, Gg^Fp, Gg^Fds, Hh^Fms, Gg^Fms, Gs^Fms, Hh^Es, Gs^Fds, Hh^Em, Gs^Fms, Gs^Fp, Gs^Em, Hh^Fmw, Gll^Fdw, Gll^Fdw, Ss^Tf, Sm^Em, Sm, Wwg, Wwg, Wwg^Edb, Ss^Tf, Wwg, Ss^Em, Sm, Wwg, Re^Em, Gll^Fdw, Gll^Fp, Gll^Fp, Gs^Fms, Gs^Fms, Gs^Fds, Gs^Fds
Gg^Efm, Rp, Rp, Rp, Rp, Gs^Fmw, Rp, Rp, Rp, Gg^Fet, Rp, Wo, Wo, Gg^Fet, Gg^Fds, Gg^Fp, Gs^Fms, Hh^Fms, Hh^Em, Gs^Fds, Gs^Fds, Gs^Fms, Hh^Fmw, Hh^Em, Hh^Es, Gll^Fp, Gll^Emf, Ss^Em, Ss^Em, Ss^Emf, Wwg^Edb, Ss^Em, Ss^Emf, Wwg^Edb, Ss^Em, Ss^Emf, Sm, Gll^Fdw, Re^Em, Gll^Fmw, Gs^Em, Gll^Em, Gs^Fms, Gs^Fms, Gs^Fms, Gs^Fms
Gg^Fds, Gs^Em, Gs^Fp, Gs^Fms, Gs^Fms, Rp, Gg^Fms, Gg^Fp, Wo, Rp, Gg^Efm, Rp, Wo, Wo, Wo, Gg^Fms, Gs^Fds, Hh^Fds, Gs^Fds, Gs^Fds, Gg^Ve, Gs^Fp, Gs^Fmw, Gg, Gg^Es, Gll^Em, Re^Es, Ss, Ss^Em, Ss^Em, Wwg^Edb, Ss^Em, Gll^Fmw, Wwg^Ewl, Wwg, Sm^Em, Sm, Gll^Fdw, Gll^Fmw, Gs^Efm, Gs^Efm, Gg^Fmw, Gs^Fms, Gll^Fp, Gs^Efm, Gs^Fms
Gg^Fms, Gg^Ve, Gs^Fms, Gs^Fds, Gg^Emf, Gg^Fms, Gg^Fms, Gg^Fms, Wo, Rp, Cv, Gg^Fet, Cv, Rp, Rp, Gg^Fms, Gg^Fds, Gs^Fms, Gg^Em, Gs^Fms, Gs^Fms, Gs^Fds, Gs^Fms, Hh^Fmw, Hh^Es, Gs^Es, Gll^Em, Re^Em, Gll^Fmw, Wwg, Ss^Em, Sm^Em, Sm^Em, Ss^Tf, Sm^Emf, Hh^Fdw, Hh, Re^Es, Re^Es, Hh^Fdw, Gll^Em, Hh^Fp, Gs^Efm, Gs^Fms, Hh^Fp, Gg
Gg^Fds, Gs^Fds, Gs^Fms, Gs^Fms, Gg^Fds, Gg^Fds, Gg^Efm, Gg^Fet, Wo, Wo, Gg^Fet, Kv, Gg^Fet, Gg^Efm, Rp, Gg^Fet, Gg^Fms, Gg^Em, Gg^Efm, Gs^Fds, Gg^Em, Gs^Fp, Gs^Fmw, Hh^Fp, Gs^Fp, Gs^Em, Gs^Em, Gll^Fp, Gll^Fmw, Wwg^Ewl, Ss^Em, Sm^Emf, Gll^Fdw, Sm^Em, Re^Em, Gll^Fdw, Hh, Gll^Emf, Hh, Hh^Fmw, Gll^Emf, Gg^Fmw, Hh, Gll^Em, Hh^Fms, Gg^Fms
Gg^Emf, Gs^Fds, Gs^Fms, Gs^Fp, Gs^Fms, Gg^Fms, Gg^Efm, Gs^Fms, Wo, Rp, Gg^Efm, Cv, Wo, Rp, Wo, Gg^Fds, Gg^Fms, Gs^Fp, Gg, Gg^Efm, Gs^Fp, Gs^Fms, Hh^Fmw, Gg^Efm, Gs^Fms, Hh^Fmw, Hh^Fp, Gll^Emf, Hh^Fdw, Wwg^Ewl, Ss, Ss^Tf, Gll^Fmw, Re^Em, Hh^Fdw, Gll^Emf, Gll^Fp, Hh^Fmw, Hh^Fmw, Hh^Es, Hh^Fdw, Hh^Es, Hh^Fmw, Gll^Em, Hh^Fmw, Hh^Fmw
Gg^Fds, Gs^Fms, Gs^Fp, Gll^Em, Gg^Em, Gg^Fms, Gg^Fds, Gg^Efm, Gg^Fds, Rp, Rp, Rp, Wo, Wo, Gg^Fds, Gg^Efm, Gg^Fms, Gg^Fms, Gg^Ve, Gs^Fms, Hh^Fds, Gs^Fds, Hh^Em, Gs^Fms, Hh^Fmw, Hh^Fp, Gs^Fmw, Hh, Gll^Fmw, Wwg, Hh^Fdw, Gll^Fdw, Hh^Es, Gll^Emf, Hh^Es, Gll^Fmw, Hh^Fmw, Gll^Em, Hh^Es, Hh, Mm, Hh, Mm, Hh^Es, Hh^Es, Mm
Gg^Fds, Gll^Emf, Gs^Em, Gs, Gll^Em, Gs^Fms, Gs^Fms, Gg^Fms, Gg^Fms, Gg^Fet, Gg^Fp, Wo, Gg^Fms, Gg^Fet, Gs^Fms, Gg^Fms, Gs^Fp, Gg^Fms, Gg^Efm, Gg^Em, Gg^Efm, Hh^Fds, Gs^Fmw, Gs^Fp, Gs^Fp, Hh, Gs^Em, Hh^Fmw, Ww^Ewl, Ww, Hh^Fp, Hh, Gs^Fp, Gll^Fmw, Hh^Fmw, Hh^Es, Mm, Hh^Es, Mm, Hh^Fmw, Mm, Hh^Fdw, Mm, Hh^Es, Gg^Es, Gg
Gs^Fp, Gs^Fp, Gll, Gg^Efm, Gll^Em, Gs, Gll^Em, Gs^Fp, Gg^Fms, Gg^Fds, Gg^Em, Gg^Em, Gg^Fms, Gg^Fds, Gg^Em, Gs^Fds, Gs^Fms, Gs^Fp, Gg, Gs^Fds, Gg^Ve, Gg^Em, Gs^Fp, Gg^Efm, Hh^Fmw, Hh^Es, Gs^Fdw, Ww^Ewl, Gs^Fdw, Gs^Fmw, Gs^Fmw, Gs^Fdw, Hh^Fdw, Mm, Hh^Es, Mm, Hh^Fmw, Hh^Fmw, Mm, Mm, Hh^Es, Mm, Hh^Fdw, Hh, Hh^Fmw, Gg
Gll, Gg, Gg^Efm, Gll^Em, Hh^Fdw, Gs, Gs^Em, Gg^Em, Gg^Fp, Gg^Efm, Gs^Fms, Gg^Fms, Gs^Fds, Gs^Fms, Gs^Fds, Gg^Fms, Gs^Fms, Gg^Em, Gg^Efm, Hh^Fms, Gs^Fp, Gs^Fmw, Gs^Em, Gs^Em, Gs^Fdw, Hh^Es, Gd^Es, Ww, Gd^Vh, Gs^Em, Re^Em, Gs^Fp, Mm, Mm, Hh^Es, Hh^Fmw, Mm, Hh^Es, Hh^Fmw, Mm, Gll^Emf, Hh^Es, Gg^Efm, Hh, Re^Es, Hh^Fp
Gg^Em, Gs, Gs, Gs, Hh^Fmw, Hh^Fp, Gll^Emf, Gg^Em, Hh^Em, Gg^Em, Hh^Emf, Gs^Fms, Gg^Ve, Gg^Efm, Gg^Em, Gs^Fms, Hh^Fms, Gs^Fp, Gs^Fmw, Gg, Gg^Es, Gs^Fdw, Gs, Re, Rd^Es, Re, Re, Ww, Re, Gd^Fdw, Re, Hh^Es, Mm, Mm, Hh^Fp, Hh^Fdw, Hh^Fdw, Gg^Efm, Hh, Hh, Hh, Gs^Em, Re^Es, Re, Gs^Fmw, Re
Gg^Fmw, Gs^Fmw, Gs, Gs^Em, Gs, Gs^Em, Gs^Fp, Hh^Em, Hh^Em, Gs^Fms, Hh^Fp, Hh^Fms, Hh^Fms, Hh, Hh^Fp, Gg^Fms, Gg^Emf, Hh^Fp, Gs^Fmw, Gg^Em, Gg^Fmw, Gs, Gd^Es, Gs^Es, Gs^Es, Ds^Esd, Ww, Wwf, Hh^Es, Re^Es, Gd, Hh^Es, Gs^Fmw, Gs^Fdw, Hh^Fp, Hh^Fp, Re^Es, Gg^Efm, Gs^Fmw, Gg^Em, Gs, Gs^Fdw, Re, Gs, Gll^Em, Gll
Gg^Efm, Gg^Em, Gg^Em, Gg^Efm, Gs^Fdw, Gs, Hh^Fmw, Hh^Fds, Hh^Fp, Hh^Em, Hh^Fp, Hh^Fms, Mm, Hh, Gs^Fds, Gg^Fp, Gg^Em, Hh^Fp, Ww, Ww, Ww, Ww, Ww, Ww, Wwf, Ds, Hh^Fp, Hh^Es, Mm, Mm, Hh^Fms, Gs^Es, Re^Em, Gs^Fmw, Re, Re^Es, Hh^Fdw, Re, Hh^Vhh, Hh, Re^Es, Re, Gs^Fmw, Gll^Fmw, Gs^Fms, Gll^Fp
Gg^Efm, Gs, Wwg^Ewl, Gs, Hh^Fmw, Hh, Gs^Fp, Hh^Fmw, Gs^Em, Gs^Emf, Hh^Emf, Mm, Hh^Vhh, Hh, Hh^Fms, Gg^Fp, Hh, Ww, Wwf, Gd^Es, Ce, Gd^Es, Ds^Esd, Ds, Wwf, Wwf, Gs^Fdw, Hh^Es, Mm, Mm, Mm, Hh^Em, Hh^Fdw, Re, Mm, Hh^Es, Hh^Fdw, Re, Re, Re^Es, Gs, Gs, Gll^Emf, Gll^Fp, Gs^Fds, Gs^Fds
Gll^Fmw, Wwg, Wwg, Wwg, Wwg^Edb, Gg, Gg, Gg, Ww, Hh^Fp, Ww^Ewl, Hh, Re, Gs, Wwf, Hh^Fms, Wwf, Wwf, Hh^Es, Ce, 2 Ke, Ce, Rd^Edb, Ww, Hh, Ds^Esd, Gd^Es, Hh^Es, Hh^Vhh, Mm, Hh^Em, Hh^Emf, Mm, Hh^Fp, Mm, Mm, Hh^Es, Hh^Es, Re^Es, Re, Gs^Efm, Gs^Fdw, Gll^Fp, Gs^Fms, Gs^Fms, Gs^Fds
Sm, Wwg, Ss^Em, Gs^Fdw, Sm, Wwg^Edb, Wwg, Ww, Wo^Edb, Ww, Ww^Ewl, Ww^Ewl, Re, Gd^Fdw, Wwf, Wwf, Ww, Wwf, Mm, Hh^Es, Ww, Ww, Wo, Ww, Hh^Vhh, Hh, Re^Edb, Re^Es, Re^Es, Hh^Es, Hh^Es, Hh^Fp, Mm, Mm, Hh^Fp, Hh^Fp, Hh^Fds, Hh^Es, Gs^Es, Re^Es, Gs, Gll^Em, Gs^Fp, Gg^Fp, Gs^Fms, Gg
Wwg^Ewl, Wwg^Ewl, Re^Emf, Gll^Fmw, Gll^Fmw, Gll^Fdw, Sm, Ww^Edb, Wo, Wo, Ww, Gs^Em, Gs^Em, Re^Es, Gs^Em, Ww, Hh^Es, Mm, Mm, Hh^Es, Hh^Fdw, Wo, Wo, Mm, Mm, Mm, Hh, Hh, Ww^Ewf, Mm, Ww^Ewf, Hh^Em, Hh^Fds, Hh^Emf, Hh^Fms, Hh^Fms, Hh, Re^Es, Re^Es, Re^Vct, 1 Ke, Re^Es, Re^Es, Gll^Em, Re, Re
Hh^Fp, Gll^Fdw, Gll^Fmw, Ss^Tf, Ss, Sm, Sm, Wwg, Ww^Ewl, Ww, Ww, Wo, Wo, Re^Es, Wo, Ww, Hh, Hh^Fdw, Hh^Fdw, Wo, Re^Em, Gll^Emf, Wo, Hh^Fds, Gg^Fms, Gg^Fds, Gg^Fms, Gg^Efm, Ww, Ww, Ww, Ww^Ewf, Hh^Fds, Hh^Fds, Gd, Hh^Fds, Re, Re, Re^Vct, Ce, Ce, Ce, Re^Vct, Re, Gs^Fms, Re
Hh^Fp, Mm, Hh^Fp, Hh^Em, Re^Es, Re^Fdw, Mm, Hh, Gs^Fms, Gs^Fds, Gs^Efm, Wo, Gg^Efm, Wo^Bw|, Gg, Wo, Wo, Wo, Wo, Wo, Wo, Wo, Wo, Hh^Fp, Ww^Ewl, Gg^Fp, Ww, Wwf, Re, Ww^Ewl, Ww, Ww^Ewf, Gs^Es, Gs^Fms, Re, Re, Gd^Fms, Ww^Ewl, Gs^Efm, Re^Es, Gs^Es, Gs^Es, Gg^Efm, Gs^Fp, Hh, Gg
Hh^Fmw, Hh^Fmw, Hh^Em, Hh^Fdw, Gll^Fmw, Hh^Fmw, Hh^Es, Hh^Fds, Hh^Fms, Gll^Fms, Hh^Fp, Hh, Hh, Re^Es, Re^Es, Gs, Re^Es, Re, Re^Es, Ww, Ww, Wo, Ww, Ww, Ww, Ww, Ww, Re, Wwf, Re, Re, Re, Re, Re, Ww, Gd, Ww, Ww^Ewl, Gs^Fms, Gs^Fp, Hh^Es, Hh^Es, Ww^Ewf, Ww^Ewl, Ww, Ww^Ewl
Gll^Fmw, Mm, Mm, Hh^Fdw, Mm, Mm, Hh^Es, Hh^Fmw, Hh^Em, Hh^Fp, Gs^Fmw, Hh^Fdw, Re, Re^Es, Gs^Vc, Re^Es, Gs^Fdw, Gg, Re, Gs^Fmw, Gs, Re^Es, Re, Re^Es, Gg^Em, Ww^Ewl, Gg^Efm, Wwf, Gs^Fp, Ww, Ww, Ww, Ww^Ewl, Ww^Ewl, Ww, Ww, Ww, Ww, Ww^Ewl, Hh^Es, Mm, Mm, Mm, Ww, Wo, Ww
Mm, Mm, Gll^Fdw, Mm, Gll^Emf, Gll^Em, Mm, Hh^Fmw, Hh^Em, Gll^Emf, Gg^Efm, Gg, Re^Es, Gs^Fdw, Hh, Gs^Fmw, Gll^Fmw, Gs^Fmw, Gs, Re^Es, Gs^Fp, Gs^Fmw, Re^Es, Re, Re^Es, Gg^Fmw, Gs, Gs, Ww^Ewl, Ww^Ewl, Ww, Ww, Ww, Ww^Ewf, Ww^Vm, Ww^Ewf, Hh, Ww, Mm, Hh^Em, Hh^Fdw, Hh^Fdw, Mm, Mm, Wo, Hh
Hh^Es, Mm, Gll^Emf, Hh^Fdw, Hh, Mm, Hh^Fp, Hh^Es, Hh^Fp, Gs^Em, Gg^Fms, Re, Gs^Es, Hh, Hh^Fms, Gll^Fp, Gll^Emf, Gll^Fp, Gs^Fmw, Re^Es, Re, Re^Es, Gs, Gs^Fmw, Gg^Efm, Re, Gg^Fmw, Gg^Efm, Gs, Ww, Ww, Ww, Ww^Ewl, Gs^Fp, Gll^Emf, Hh^Fmw, Mm, Ww, Wo, Mm, Wo, Mm, Mm, Wo, Mm, Hh
Hh, Hh^Es, Hh^Fmw, Mm, Hh^Fp, Mm, Hh^Fds, Hh^Fp, Gs^Vh, Hh, Re, Re, Hh, Gs^Em, Hh^Fp, Gs^Fds, Gll^Fms, Gll^Em, Gs, Gg^Efm, Gg^Fp, Gg^Efm, Gs^Fms, Gs^Em, Gs^Fp, Re, Gs^Fp, Gg^Efm, Gs^Fp, Gg^Efm, Gg^Efm, Ww, Gs, Gll^Em, Gg^Fmw, Hh^Fmw, Hh, Mm, Wo, Wo, Mm, Mm, Mm, Mm, Hh^Fdw, Hh
Mm^Xm, Mm, Hh^Fmw, Mm, Gll^Fms, Hh^Fmw, Gs^Fds, Gll^Emf, Hh^Fmw, Re^Es, Gs^Fp, Gs^Fms, Hh^Fds, Hh^Fms, Hh^Fds, Hh^Fds, Gs^Fms, Gll^Em, Gs^Em, Gs^Em, Gs^Fms, Gs^Fms, Gs^Fds, Gs^Fms, Gll^Em, Gs^Vl, Gs^Fms, Gs^Fds, Gs^Fms, Gs^Efm, Ww, Ww, Hh, Gs^Efm, Gll^Emf, Hh^Fmw, Hh^Fmw, Hh, Mm, Wo, Mm, Hh^Fdw, Hh^Es, Mm, Hh^Es, Hh
Mm^Xm, Hh^Fmw, Hh, Gll^Emf, Gg, Hh^Fms, Gs^Fds, Gg^Fms, Gg, Re, Gs^Fds, Hh^Fds, Gs^Fds, Hh^Fds, Gs^Fds, Hh^Fds, Gs^Fds, Gs^Fds, Gs^Fds, Gs^Fms, Gs^Fds, Gs^Fds, Gs^Fds, Gs^Fms, Gs^Fds, Gs^Fms, Gs^Fds, Gs^Fds, Gs^Fds, Ww^Ewl, Gs^Fp, Ww, Hh, Hh, Hh, Hh^Fp, Gg, Hh, Mm, Mm, Mm, Mm, Hh, Mm, Hh, Hh
