Gg^Efm, Gg^Efm, Gg^Efm, Rp, Rp, Gg, Rp, Gg, Gg, Gg^Fms, Gg^Fds, Gg^Fds, Gg, Gg^Fms, Gg^Fds, Gg^Fds, Gg^Fms, Gg^Fms, Gg^Fms, Gg, Gg^Fds, Gg, Gg, Gs, Gg, Gg^Fds, Gg, Gg, Gg, Gg, Gg, Gg, Gs, Gg^Fds, Gg^Fds, Gg, Gg, Gs, Gs, Gs, Gs, Gs, Gs, Gs, Gs, Gs, Gs, Gs
Gg^Fds, Gg^Fds, Gg^Fds, Gs^Em, Gg^Fet, Gg^Fms, Gg, Rp, Gg^Fms, Gg^Fds, Gg^Fds, Gg^Fds, Gg, Gg, Gg^Fms, Gg^Fms, Gg^Fds, Gg^Fds, Gg, Gg^Fds, Gg, Gg^Fds, Gs, Gg, Gs, Gg, Gg, Gg, Gg, Gg^Fds, Gg^Fms, Gg^Fms, Gg^Fds, Gg^Fds, Gs, Gg^Fds, Gg^Qhh, Gg, Gg, Gs, Gs, Gs, Gs, Gs, Gs, Gs, Gs, Gs
Gg^Fp, Gg^Fp, Gg^Fp, Gg, Rp, Rp, Rp, Ww, Ww, Gg, Gg, Gg, Gg^Fms, Gg^Fms, Gg^Fds, Gg^Fds, Gg^Fds, Gg^Fds, Gg, Gg, Gs, Gs, Gs, Gs, Gs, Gg, Gs, Cer, Gg, Gg, Gs, Gs, Gg, Gg^Fds, Gs^Qhh, Gg^Qhh, Gg, Gg^Qhh, Gs^Qhh, Gs, Gs, Gs, Gs^Qhh, Gs, Gs, Gs, Gg^Fds, Gg
Gg^Fms, Gg^Fms, Gg^Fms, Gg, Rp, Gg^Efm, Gg^Fet, Ww, Rp, Gg^Fet, Gg, Gg, Gg, Gg^Fds, Gg^Fds, Gg^Fds, Gg, Gg^Fds, Gg^Fds, Gg, Gg^Fds, Gs, Gs, Gs, Gs, Gs, Gs, Gs, Gs, Gs, Gs, Gg, Gs, Gs^Qhh, Gs, Gs, Gs, Gs, Gs, Gg^Qhh, Gs^Qhh, Gs^Qhh, Gs, Gs^Qhh, Gs, Gg^Fds, Gg, Gs
Gg^Fet, Gg^Fp, Gg^Fet, Ww, Ww, Cv, Kv, Cv, Gg^Efm, Rp, Gg, Gg^Efm, Gg, Gg^Fds, Gg^Fms, Gg^Fms, Gg, Gg, Gg, Gg^Fds, Gg, Gg, Gg, Gs^Qhh, Gs, Cer, Gs, Gs, Gs, Gs, Gs, Gs, Gs, Gs, Gs, Gs, Gs, Gs, Gg^Fms, Gg^Fms, Gg^Fms, Gs, Gs^Qhh, Gs^Qhh, Gs, Gs, Gg, Gs
Gs^Fms, Gs^Fms, Gs^Fms, Ww, Rp, Gg^Fet, Cv, Gg^Fet, Rp, Rp, Gg^Fds, Gg^Efm, Gg^Efm, Gg, Gg, Gg^Fds, Gg^Fds, Gg, Gs, Gs, Gs, Gs, Gs, Gs^Qhh, Gs, Gs, Gs, Gs, Gs, Gs, Gs, Gs, Gs, Gs, Gs, Gs, Gs, Gs, Gg^Fds, Gs, Gg, Gg^Qhh, Gg^Fds, Gs, Gg, Gg, Gs, Gg
Gg^Fds, Gg^Fds, Gg^Fds, Gg, Rp, Gg^Efm, Rp, Ww, Ww, Ww, Gg^Fms, Gg, Gg, Gg^Efm, Gg, Gg^Fds, Gg^Fds, Gg, Gs, Gs, Gs, Gs, Gs, Gs^Qhh, Gs^Qhh, Hh, Hh, Gs, Gs, Gs, Hh^Qhh, Gs, Hh, Gs, Hh, Gs, Gg, Gg^Fds, Gg, Gg, Gg^Qhhf, Gg^Qhhf, Gg, Gg^Fms, Gg^Fds, Gg^Fds, Gg^Fds, Gs
Gs^Fp, Gs^Fp, Gs^Fp, Gg^Fds, Gg^Fet, Rp, Ww, Ww, Gg^Fet, Gg^Fds, Gg^Fms, Gg^Fds, Gg, Gg^Efm, Gg^Efm, Gg, Gg, Gg, Gs, Gs, Gs, Gs, Gs, Gs, Gs, Hh^Qhh, Hh, Gs^Qhh, Gs^Qhh, Gs^Qhh, Gs, Hh^Qhh, Hh^Qhh, Hh, Gs, Gg, Hh^Qhh, Gg, Gs^Qhh, Gg^Qhh, Gg^Fds, Gs, Ce, Gg^Fms, Gg, Gg^Fds, Gg^Fds, Gs
Gg^Qhu, Gg, Gg, Gg, Gg^Efm, Gg^Fp, Gg, Gg, Gg, Gg, Gg^Qhu, Gg, Gg, Gg, Gg, Gg^Efm, Re, Gs, Gs, Gs, Re, Gs, Gs, Gs, Gs, Gs^Qhh, Gs^Qhh, Gs, Hh, Hh, Hh^Qhh, Hh, Gs^_mh, Gs^Qhh, Hh^Qhh, Hh^Qhh, Gs, Gs^Qhh, Re, Gs, Re, Re, Ce, Ke, Gg, Gg, Gg, Gg
Gg, Gg^Qhu, Gg^Qhu, Gg, Gg^Qhuf, Gg^Qhuf, Gg^Qhuf, Gg^Qhuf, Gg^Qhuf, Gg^Qhu, Gg^Fds, Gg^Qhuf, Gg^Qhuf, Gg^Fms, Gg, Gg, Gg, Re, Re, Gg, Gg, Re, Gs, Gs, Gs, Gs, Hh, Gs^Qhh, Hh^Qhh, Hh^Qhh, Gs, Gs^Qhh, Gs^Qhh, Gs^Qhh, Gs, Gs, Re, Re, Rb, Rb, Gs, Re, Rb, Ce, Re, Rb, Re, Rb
Gg^Fms, Gg^Fms, Gg^Fms, Gg^Qhuf, Gg^Fms, Gg^Fms, Gg^Fms, Gg^Fds, Gg^Fds, Gg, Gg^Fds, Gg^Fms, Gg^Fds, Gg^Qhuf, Gg^Qhuf, Gg, Gs, Gg, Gg, Gg, Gg, Gs, Gs, Re, Re, Re, Gs, Hh, Re, Hh, Gs, Gs, Gs, Gs, Re, Gs, Gs, Gs, Gs, Gs, Gs, Gs, Gs, Gs, Gs, Rb, Gs, Gs
Gg, Gg, Gg, Gg^Fds, Gg^Fds, Gg^Fds, Gg^Fds, Gg^Fds, Gg, Gg, Gg, Gg^Fds, Gg, Gg^Fds, Gg^Qhuf, Gg^Fds, Gg, Gs, Gg, Gg, Gg^Fds, Gg, Gg^Fds, Gs, Gs, Re, Gs, Re, Rb, Rb, Rb, Gs, Gs, Re, Gs, Gs, Gs, Gs, Gs, Gs, Gs, Gs, Gs, Gs, Gs, Gs, Gs, Gs
Gg^Fds, Gg^Fds, Gg^Fds, Gg^Fds, Gg^Fds, Gg, Gg, Gg, Gg^Fds, Gg, Gg^Efm, Gg, Gg, Gg^Fds, Gg^Qhuf, Gg^Fds, Gg, Gg, Gg^Fds, Gg^Fds, Gs, Gg^Fds, Gg, Gg^Fds, Gs, Re, Gs, Gs, Gs, Gs, Gs, Gs, Gs, Gs, Gs, Gs, Re^Gvs, Gs, Gs, Gs, Gs, Gs, Gs, Gs, Gs, Gs, Gs, Gs
Gg^Fds, Gg^Fds, Gg^Fds, Gg^Fds, Gg^Fds, Gg, Gg^Fms, Gg^Fds, Gg^Fds, Gg^Efm, Gg^Efm, Gg^Efm, Gg^Efm, Gg, Gg, Gg^Qhu, Gg^Qhu, Gs, Gs, Gs, Gg^Fms, Gg^Fms, 2 Cer, Gs, Re, Re, Gs, Gs, Gs, Gs, Gs, Gs, Gs, Gs, Re^Gvs, Re^Gvs, Re^Gvs, Re^Gvs, Re^Gvs, Gs, Gs, Gs, Gs, Gs, Gs, Gs, Gs, Gs
Gg^Fms, Gg^Fms, Gg^Fms, Gg^Fms, Gg^Fms, Gg^Fms, Gg^Fms, Gg^Fds, Gg^Fds, Gg^Fds, Gg, Gg^Efm, Gg^Efm, Gg^Efm, Gg^Efm, Gg, Gg^Efm, Gg^Qhu, Gg^Qhu, Gg, Gs, Cer, Ker, Gs, Rb, Gs, Gs, Gs, Gs, Gs, Gs, Gs, Re^Gvs, Re^Gvs, Re^Gvs, Re^Gvs, Re^Gvs, Re^Gvs, Gs, Gs, Gs, Gs, Gs, Gs, Gs, Gs, Gs, Gs
Gg, Gg, Gg, Gg^Fms, Gg^Fms, Gg^Fms, Gg^Fds, Gg^Fds, Gg^Fds, Gg, Gg, Gg^Efm, Gg, Gg^Efm, Gg^Efm, Gg^Efm, Gg^Efm, Gg^Efm, Gg^_ml, Gg^Qhu, Gg, Gs, Cer, Cer, Rb, Gs, Gs, Gs, Gs, Gs, Gs, Gs, Gs, Re^Gvs, Re^Gvs, Re^Gvs, Gs, Gs, Gs, Gs, Gs, Gs, 1 Gs, Gs, Gs, Gs, Gs, Gs
Gg^Fds, Gg^Fds, Gg^Fds, Gg^Fds, Gg^Fds, Gg^Fds, Gg, Gg, Gg^Fds, Gg, Gs, Gg^Efm, Gg^Efm, Gg^Efm, Gg^Efm, Gg, Gg, Gg^Efm, Gs^Qhu, Gs^Qhu, Gg, Gg, Gg, Rb, Rb, Gs, Cer, Gs, Gs, Gs, Gs, Gs, Gs, Gs, Gs, Gs, Gs, Gs, Gs, Gs, Gs, Gs, Gs, Gs, Gs, Gs, Gs, Gs
Gg^Fms, Gg^Fms, Gg^Fms, Gg^Fds, Gg^Fds, Gg, Gg, Gg, Gg^Fms, Gg^Fms, Gs, Gg^Efm, Gg^Efm, Gg^Efm, Gg^Efm, Gg^Efm, Gg^Efm, Gg^Qhu, Gg, Gg, Re, Re, Gs, Gg, Gg, Gs, Gs, Gs, Gs, Gs, Gs, Gs, Gs, Gs, Gs, Gs, Gs, Gs, Gs, Gs, Gs, Gs, Gs, Gs, Gs, Gs, Gs, Gs
Gs, Gs, Gs, Gg^Fms, Gg, Gg, Gg, Gs, Gg^Fds, Gg, Gg^Efm, Gg^Efm, Gg^Efm, Gg, Gg, Gg^Efm, Gs^Qhu, Gs^Qhu, Gs, Re, Re, Gg, Gg, Gg, Gg, Gg, Gs, Gs, Gs, Gs, Gs, Gs, Gs, Gs, Gs, Gs, Gs, Gs, Gs, Gs, Gs, Gs, Gs, Gs, Gs, Gs, Gs, Gs
