Mm^Qhu, Mm^Qhuf, Hh^Qhuf, Mm^Qhuf, Hh^Qhuf, Hh^Qhuf, Hh^Qhu, Gg^Qhu, Gg^Qhu, Re^Es, Re^Es, Gs^Fms, Gs^Fms, Gg^Fet, Gs^Fds, Gs^Fms, Gll^Emf, Gs^Fms, Re, Re^Es, Gs^Em, Re, Gs^Fp, Gg^Efm, Gg^Efm, Gg^Em, Gg^Fp, Gs^Em, Hh^Fms, Hh^Fms, Gg^Efm, Gg^Efm, Gg^Fp, Gg^Fp, Ww^Ewl, Gg^Efm
Hh^Qhuf, Mm, Mm, Hh^Fdw, Hh^Em, Hh^Fmw, Hh^Em, Hh^Fms, Hh^Fds, Gs^Qhuf, Gs^Qhuf, Re^Es, Gs^Fds, Gs^Fds, Gs^Fms, Gll^Em, Gs^Fp, Gs^Em, Re, Gs^Fp, Gg^Fmw, Gg^Efm, Hh^Fp, Hh^Fms, Gg^Em, Hh, Hh^Fms, Ww^Ewf, Ww, Ww^Ewf, Wwf, Gg^Fms, Gg^Fms, Gg^Fms, Ww^Ewl, Ww
Hh^Qhuf, Hh^Fds, Gll^Fp, Hh^Fmw, Gs^Fms, Gll^Emf, Hh^Em, Mm, Hh^Fds, Gs^Fds, Gs^Qhuf, 1 Re^Es, Re^Es, Gs^Fms, Re, Re^Es, Re, Gs^Fmw, Re^Es, Gg^Fmw, Ww, Ww^Ewf, Hh^Fp, Hh^Fms, Hh^Fms, Hh^Fp, Hh^Fms, Ww^Ewf, Ww^Ewf, Ww, Gg^Fms, Wwf, Ww, Ww^Ewl, Ww, Ww^Ewl
Hh^Qhuf, Hh^Fms, Gll^Emf, Gll^Fp, Hh^Fms, Gs^Fms, Gs^Fms, Hh^Fms, Gll^Em, Gs^Em, Hh^Fds, Gs^Qhuf, Gg^Efm, Re, Gs^Fmw, Gs^Fp, Gs, Re, Gg^Efm, Ww^Ewf, Ww^Ewl, Ww, Gg^Fp, Hh, Gs^Fms, Hh^Fp, Hh^Fms, Gg^Fds, Gg^Efm, Ww, Gg^Fms, Gg^Efm, Ww, Ww, Gg^Qhhf, Ww^Ewl
Gs^Qhuf, Gs^Em, Gll^Fms, Hh^Fms, Hh^Fds, Hh^Fms, Gs^Em, Gll^Fds, Gll^Fp, Hh^Fms, Hh^Fms, Gs^Qhuf, Gs^Qhuf, Re, Gg, Gg^Efm, Gs^Ve, Re, Ww^Ewf, Ww, Ww^Ewf, Ww, Ww, Gs^Em, Gs^Fmw, Hh^Fp, Gg^Fms, Gg^Fms, Gs^Em, Ww, Hh^Qhh, Ww^Ewf, Ww^Ewf, Ww^Ewf, Gg^Qhhf, Gg^Qhhf
Hh^Qhuf, Hh^Fms, Hh^Fms, Gll^Fds, Gll^Em, Gs^Fp, Gll^Em, Gll^Fms, Gg^Fmw, Hh^Fp, Gll^Emf, Hh^Fp, Gs^Qhuf, Re, Gg^Efm, Gs^Fms, Hh^Fms, Rp, Gs^Fms, Gs^Fmw, Hh^Fmw, Hh, Ww, Ww, Ww, Gs^Em, Gg^Efm, Gg^Efm, Ww, Ww, Hh^Qhhf, Gg^Qhhf, Hh^Qhhf, Gg^Qhhf, Gs^Fms, Gs^Qhhf
Hh^Qhuf, Mm, Mm, Gs^Fp, Gg^Qhu, Gg^Efm, Gs^_ml, Gll^Em, Gll^Em, Hh, Hh^Qhu, Gll^Qhu, Rp, Rp, Hh, Gs^Fms, Gs^Fms, Rp, Rp, Gs^Fp, Gg^Efm, Hh, Gg^Efm, Ww, Ww, Gs^Em, Gg, Gg, Ww, Gs^Qhhf, Gs^Fp, Gs^Fds, Gs^Fms, Hh^Fds, Gs^_mh, Gg^Qhhf
Hh^Qhuf, Mm^Qhu, Hh^Qhu, Hh^Qhu, Re, Gs^Qhu, Hh^Qhu, Hh^Es, Gs^Qhu, Gs, Gs^Qhu, Gs, Rp, Gg^Efm, Gg^Ve, Hh^Fms, Rp, Rp, Mm, Rp, Rp, Rp, Rp, Gg, Ww^Ewf, Ww, Ww, Gg^Efm, Ww, Gs^Qhhf, Gs^Em, Gs^Fms, Gs^Fms, Gs^Qhhf, Gg^Qhhf, Gs^Qhhf
Re, Re, Re^Es, Re^Es, Hh^Es, Re, Re, Gs^Qhu, Cvr, Gs^Qhu, Cvr, Gg^Efm, Rp, Rp, Rp, Rp, Hh^Fp, Hh^Fp, Hh, Hh, Gs^Em, Gs^Em, Wwf, Wwf^Bsb\, Rp, Ww, Cvr, Ww, Ww, Gg^Qhh, Gg^Efm, Gs^Fms, Gs^Fds, Gg^Em, Gs^Em, Gs^Qhhf
Hh^Fp, Hh^Es, Hh^Fp, Gs^Em, Hh^Fms, Hh^Fp, Gs^Es, Re, Rp, Kvr, Rp, Rp, Wwf, Wwf, Ww^Ewl, Ww^Ewl, Mm, Mm, Mm, Mm, Ww, Hh^Fp, Ww, Gg, Rp, Cvr, Kvr, Ww, Gs^Qhhf, Gs^Qhhf, Gs^Fms, Gs^Fms, Gs^Fms, Gs^Fp, Gll^Emf, Gg^Qhhf
Mm, Mm, Hh^Fp, Gs^Em, Gll^Fdw, Gll^Fmw, Hh^Fmw, Re, Re^Es, Cvr, Rp, Rp, Hh^Es, Hh^Es, Hh^Em, Ww^Ewl, Mm, Mm, Mm, Ww, Mm, Ww, Hh, Gg^Efm, Rp, Cvr, Ww, Ww, Gs^Qhhf, Hh^Fds, Hh^Fms, Hh^Fms, Gg^Fp, Gs^Efm, Gs^Fms, Gs^Fms
Hh^Fp, Mm, Gll^Em, Gll^Em, Hh^Fp, Hh^Fmw, Hh, Gg, Gg, Re^Es, Re^Es, Wwf, Wwf, Gg^Ve, Gs^Fp, Ww, Ww, Hh^Fds, Gg^Fet, Mm, Hh^Fp, Hh, Gs^Fmw, Gg, Ww, Ww, Ds, Ds^Qhh, Gs^Qhhf, Hh^Fds, Hh^Fms, Mm, Hh^Fds, Gg^Fp, Gs^Fms, Gs^Fp
Gs^Fms, Hh^Fp, Hh^Em, Gll^Em, Hh^Fp, Hh^Fp, Mm, Gg, Gg, Hh^Em, Re^Es, Wwf, Ww^Ewl, Ww, Ww, Hh^Em, Ww, Hh^Fms, Gg^Em, Hh^Fp, Hh^Fms, Ww^Ewl, Ww, Ww^Ewl, Ww, Gs^Fms, Gs^Fms, Ds, Gs^Qhh, Gll^Fms, Gg^Fms, Hh^Fds, Gll^Emf, Hh, Gs^Fms, Gs^Fp
Hh, Gll^Fmw, Gll^Fdw, Hh^Em, Hh^Fmw, Mm, Mm, Hh, Hh^Fmw, Mm, Re, Hh^Fp, Mm, Mm, Mm, Ww, Ww, Hh, Gs, Gg^Efm, Gs^Ve, Ww^Ewl, Ww, Ww^Ewf, Gs^Fds, Gs^Fds, Gs^Fms, Hh^Fms, Hh^Fms, Gs^Qhhf, Gs^Qhhf, Gs^Em, Hh^Qhhf, Gs^Qhhf, Gs^Fms, Gs^Fds
Hh^Fp, Gll^Fmw, Hh, Hh^Es, Hh^Es, Mm, Mm, Mm, Hh^Fp, Hh^Fp, Re, Mm, Mm, Mm, Hh^Es, Gs^Fmw, Ww^Bsb/, Ww^Bsb/, Ww^Ewl, Gs, Ww, Ww, Ww^Ewf, Gs^Fms, Gs^Fp, Gs^Fp, Gs^Fms, Hh^Fds, Gll^Em, Gs^Fp, Gs^Fms, Hh^Qhhf, Hh^Em, Gs^Qhhf, Mm, Gs^Fms
Hh, Hh^Fp, Gs^Emf, Hh^Fdw, Gg^Em, Hh^Es, Hh^Em, Hh^Fms, Hh^Fp, Mm, Hh^Fp, Re, Hh^Es, Hh^Fmw, Re, Re^Es, Gs^Fp, Ww, Ww, Ww^Ewl, Gg^Ve, Gs^Fms, Gs^Fp, Rp, Hh^Fp, Hh^Es, Hh^Fms, Gs^Fms, Hh^Fp, Hh^Es, Hh^Em, Hh^Fms, Hh^Fp, Gs^Qhhf, Hh^Em, Hh^Fms
Hh^Fms, Gs^Fdw, Hh^Fp, Gg^Em, Mm, Mm, Mm, Gs^Fms, Gs^Fms, Hh^Fp, Gg^Efm, Re^Es, Re^Es, Re, Gg^Ve, Hh^Fp, Gg, Ww^Ewl, Ww^Ewl, Ww, Re, Gs, Re, Re, Cvr, Mm, Mm, Hh^Fp, Hh^Em, Gll^Emf, Hh^Fp, Mm, Mm, Mm, Hh^Fms, Hh^Fds
Hh^Fds, Hh^Fp, Mm, Hh^Fds, Mm, Mm, Mm, Gg^Fet, Gs^Fds, Gs^Fms, Gg^Em, Re, Gs^Efm, Hh^Fp, Re, Gs^Fms, Re, Gg, Re, Wwf^Bsb/, Gs^Fmw, Re, Cvr, Kvr, Cvr, Gll^Qhhf, Gs^Fds, Hh^Es, Hh^Fp, Mm, Mm, Hh, Mm, Mm, Mm, Mm
Mm, Hh^Fms, Mm, Mm, Mm, Mm, Gs^Fp, Gs^Fds, Gs^Fms, Gg^Ve, Gs^Fp, Re, Re, Re, Gll^Emf, Re, Gg, Re, Gg, Wwf, Ww, Gs^Fp, Gs^Qhh, Hh^Qhhf, Gll^Qhh, Gll^Qhhf, Gll^Qhhf, Gs^Fms, Mm, Hh^Fmw, Mm, Hh^Fp, Hh^Fmw, Mm, Mm, Mm
Mm, Mm, Mm, Mm, Hh^Fmw, Mm, Hh^Fp, Hh^Fms, Hh^Es, Gs^Fms, Gg^Efm, Gg^Efm, Re^Es, Hh^Fds, Hh, Hh, Mm, Hh^Fmw, Gg, Gll^Fms, Gs^Fms, Ww, Gs^Qhhf, Hh^_mh, Hh^Fds, Gs^Fds, Mm, Hh^Qhhf, Mm, Mm, Mm, Mm, Mm, Mm, Mm, Mm
Mm, Mm, Mm, Mm, Mm, Hh, Hh^Fp, Hh^Es, Hh^Fmw, Gs^Em, Gs^Fmw, Re, Gs^Fp, Gg^Ve, Hh^Fds, Mm, Mm, Hh, Gs^Fms, Gs^Fds, Hh^Fds, Ww, Gs^Qhhf, Gs^Fms, Hh^Qhh, Hh^Qhhf, Mm^Qhh, Mm^Qhh, Mm, Hh^Fmw, Hh, Mm, Mm, Mm, Mm, Mm
Hh^Fmw, Hh^Fmw, Mm, Mm, Mm, Mm, Hh^Fp, Hh^Fp, Hh^Es, Hh^Es, Gll^Em, Re, Gll^Fmw, Gs^Fms, Gs^Fms, Gs^Fms, Hh^Em, Hh^Fp, Gll^Emf, Gs^Fms, Ww, Ww^Ewl, Ww^Ewl, Gs^Qhhf, Ww, Ww^Ewl, Ww, Mm^Qhh, Mm^Qhh, Mm, Hh, Hh^Fmw, Mm, Mm, Mm, Mm
Hh^Em, Mm, Hh^Fmw, Mm, Hh^Fp, Hh^Em, Gs^Fds, Gs^Fms, Hh^Em, Hh^Es, Re^Es, Cvr, Kvr, Hh^Fds, Gs^Fp, Hh^Fp, Hh^Fp, Hh^Em, Hh^Em, Ww^Ewl, Ww, Ww, Wo, Ww, Wo, Wo, Ww, Ww^Ewl, Hh^Qhhf, Mm, Hh^Fmw, Hh^Fmw, Mm, Mm, Mm, Mm
Hh^Fmw, Hh, Mm, Mm, Hh^Fds, Hh^Em, Gs^Fms, Gs^Fms, Gll^Em, Gs^Fmw, Re, Cvr, Hh^Es, Gs^Fms, Hh^Em, Hh^Emf, Hh^Fmw, Hh^Fmw, Wwf, Wwf, Ww, Wo, Wo, Wo, Wo, Ww, Hh, Ww^Ewl, Hh^Qhhf, Mm, Mm, Mm, Mm, Mm, Hh^Fmw, Hh
Ww^Qhu, Ww^Qhu, Ww^Qhu, Hh^Fp, Hh^Fmw, Gs^Fp, Hh^Fmw, Hh^Fdw, Gs^Fdw, Re^Es, Hh^Fmw, Hh^Es, Hh^Fmw, Hh^Fmw, Mm, Mm, Mm, Ww^Ewl, Ww^Ewl, Ww, Wo, Wo, Wo, Wo, Ww, Ww, Wwf, Hh^Qhhf, Mm, Mm, Mm, Mm, Mm, Hh^Fp, Mm, Hh
Ww^Qhuf, Gg^Efm, Gs^Fp, Ww^Qhu, Gll^Fmw, Gs^Fdw, Gs^Es, Gll^Em, Gd^Vct, Re, Hh^Es, Mm, Hh, Hh, Hh^Fdw, Hh^Em, Mm, Ww^Ewl, Ww^Ewl, Wo, Wo, Wo, Ww, Ww, Ww, Wwf, Gg^Fms, Hh^Qhhf, Hh^Fp, Mm, Mm, Mm, Gll^Fp, Hh^Em, Mm, Mm
Hh^Qhuf, Gs^Fds, Gs^Fms, Wwf^Qhu, Hh, Gd^Em, Re^Ecf, Re, Re, Re, Re^Es, Gll^Em, Gll, Mm, Hh^Fdw, Hh^Fmw, Mm, Mm, Ww, Wo, Wo, Ww, Ww, Ww^Ewl, Ww, Ww^Ewf, Gs^Fms, Gs^Fds, Hh^Em, Wwf, Ww^Ewl, Hh^Em, Gll^Emf, Mm, Mm, Hh
Ww^Qhu, Gg^_ml, Wwf^Qhu, Wwf^Qhu, Gs, Hh^Fdw, Gd^Es, Gd^Es, Gs^Fmw, Hh^Es, Hh^Es, Re^Es, Re^Es, Hh, Gll^Ve, Ww^Qhu, Wwf, Mm, Ww^Ewl, Ww, Ww, Ww, Ww, Ww, Ww^Bw\, Gg^Fds, Gg^Fet, Gg^Efm, Ww^Ewf, Ww, Ww, Gs^Fp, Hh^Fp, Hh^Em, Hh^Fmw, Hh^Fmw
Ww^Qhu, Ww, Ww^Qhu, Hh^Fmw, Hh^Fmw, Gs, Gs^Fmw, Gs, Re, Mm, Mm, Hh^Es, Re, Gll^Em, Ww^Qhu, Ww^Qhu, Ww, Wwf, Ww, Ww, Ww, Ww^Ewl, Ww, Ww^Ewf, Gg^Fet, Gg^Ve, Gg^Efm, Gs^Fms, Ww, Ww, Wo, Ww, Ww, Hh^Fp, Mm, Mm
Ww^Qhu, Ww^Qhu, Hh^Fp, Gll^Fp, Hh^Fmw, Hh^Fmw, Hh, Hh^Fmw, Hh^Fmw, Hh^Fdw, Mm, Re, Mm, Hh^Fmw, Mm, Ww^Ewl, Mm, Ww^Qhu, Ww, Ww, Ww, Ww, Ww^Ewl, Gs^Fds, Gs^Fms, Gg^Fms, Gs^Fms, Gs^Fds, Ww, Ww, Wo, Wo, Ww, Mm, Mm, Mm
Ww^Qhu, Hh^Fms, Hh^Fms, Gll^Emf, Gll^Fp, Hh, Gll^Fmw, Hh^Fmw, Gd^Fmw, Hh^Es, Hh^Fdw, Re, Hh, Hh, Hh, Mm, Hh^Em, Hh^Em, Gs^Fms, Ww, Gg^Efm, Ww^Ewf, Gg^Em, Gg^Efm, Gs^Fds, Gg^Em, Ww, Ww, Ww^Ewf, Wo, Wo, Wo, Ww, Hh, Mm, Mm
Ww^Qhu, Ww^Qhu, Ww^Qhu, Hh^Fp, Wwf^Qhu, Gll^Em, Gll^Fmw, Hh, Hh, Ww^Qhu, Ww^Qhu, Wwf^Qhu, Wwf^Qhu, Hh^Fds, Ww^Qhu, Hh, Ww^Qhu, Ww^Qhu, Ww^Qhu, Ww, Hh^Em, Gs^Fms, Gs^Fp, Ww^Ewf, Ww, Wwf, Ww, Ww, Wo, Wo, Wo, Ww, Hh^Fmw, Hh^Fmw, Mm, Mm
Hh, Ww^Qhu, Gs^Fp, Ww^Qhu, Gs^Fmw, Wwf^Qhu, Wwf^Qhu, Ww^Qhu, Ww^Qhu, Ww^Qhu, Ww^Qhu, Ww^Qhu, Ww^Qhu, Ww^Qhu, Gs, Ww^Qhu, Rb, Hh^Fmw, Rb^Es, Hh^Fms, Re, Gll^Fp, Hh^Fds, Ww^Ewf, Gs^Fp, Hh^Fmw, Ww^Ewl, Ww, Wo, Wo, Wo, Ww, Ww, Mm, Mm, Mm
Gg, Hh^Fms, Gs^Fmw, Gs^Fmw, Re, Gs^Ve, Re^Es, Re, Re, Ww^Qhu, Gll^Fp, Ww^Ewl, Gll^Fp, Rb^Es, Rb, Rb, Gg^Fms, Rb^Es, Gg^Efm, Re, Gg^Fp, Hh^Fp, Mm, Gs^Fms, Mm, Hh^Fp, Hh^Fmw, Ww^Ewl, Ww^Ewf, Ww, Wo, Wo, Ww, Ww^Ewl, Mm, Mm
Re^Es, Re, Re, Re^Es, Gs^Em, Re, Gs^Fms, Gs^Fmw, Gll^Fp, Re, Re, Gll^Fp, Re^Es, Rb, Gg, 2 Gg^Fp, Cvr, Hh, Hh^Fms, Gs^Fms, Mm, Hh^Fmw, Mm, Hh^Fp, Ww, Ww, Ww^Ewl, Ww^Ewl, Ww^Ewl, Ww, Ww, Ww, Hh^Fmw, Hh^Fmw, Mm^Qhh, Mm^Qhh
Rb^Es, Gs^Fms, Gs^Fp, Gs^Fp, Gs^Em, Re, Gs^Fms, Gs^Fms, Gs^Fms, Gs, Re^Es, Re, Gll^Fmw, Gs, Gll^Fp, Cvr, Kvr, Hh, Hh, Mm, Mm, Mm, Mm, Mm, Ww, Mm^Qhh, Mm^Qhh, Mm^Qhh, Mm^Qhh, Mm^Qhh, Mm^Qhh, Ww^Ewl, Mm^Qhh, Mm^Qhh, Mm, Mm
Hh, Gs^Fp, Hh, Hh^Fms, Gs^Fds, Gs^Fms, Hh^_ml, Gll^Emf, Gs^Em, Gs^Fmw, Gs^Fms, Gll^Fp, Hh^Fmw, Hh^Fms, Hh^Fmw, Cvr, Mm, Hh^Fp, Hh^Fp, Mm, Mm, Mm, Mm, Wo, Mm^Qhh, Mm^Qhh, Hh^Qhh, Mm^Qhh, Mm^Qhh, Mm^Qhh, Mm^Qhh, Mm^Qhh, Mm^Qhh, Mm, Mm, Mm
Hh^Fds, Hh^Fms, Hh^Fds, Gs^Fms, Gs^Fds, Hh^Fp, Hh, Gs^Fds, Gs^Fms, Gs^Fms, Gs^Fds, Hh^Fp, Gs^Fms, Mm, Hh^Fds, Hh^Fds, Hh^Fds, Mm, Hh, Hh^Fmw, Hh, Mm, Mm, Wo, Mm^Qhh, Mm^Qhh, Hh^Qhh, Hh^Qhh, Hh^Qhh, Mm, Mm^Qhh, Hh^Qhh, Hh^Qhh, Mm, Mm, Mm
