Gg^Qhh, Gg^Qhh, Gg^Qhh, Gg^Qhh, Gg^Qhhf, Gg^Qhh, Gg^Qhh, Gg^Qhh, Gg^Qhh, Gg^Qhh, Gg^Qhh, Gg^Qhh, Hh^Qhhf, Hh^Qhh, Hh, Hh, Hh, Hh, Hh, Gg^Qhh, Hh^Qhh, Hh^Qhh, Gg^Qhh, Gg, Gg^Fds, Gg^Fds, Gg^Fds, Gg, Hh, Hh, Hh, Gg, Hh, Hh^Fds, Hh^Fds, Ds, Wwg, Wwg, Ds, Ds
Gg^Qhhf, Gg, Hh^Fds, Hh^Fds, Hh, Gg, Hh, Gg, Gg, Gg, Gs^Fds, Hh^Fds, Gs, Hh, Hh^Fms, Hh^Fms, Hh^Fds, Hh^Fms, Hh^Qhh, Hh, Hh^Qhh, Hh^Qhh, Hh^Fds, Hh^Fds, Gg, Gg^Fds, Hh, Hh, Hh, Hh, Hh^Fds, Hh^Fds, Hh^Fds, Hh^Fds, Gg, Ds, Wwg, Wwg, Wwg, Gs
Hh^Qhhf, Hh^Fds, Hh^Fds, Hh^Fds, Hh^Fds, Hh, Gg^Fds, Gg^Fds, Gs, Gg^Fds, Hh, Gs^Fds, Gs^Fds, Hh^Fds, Hh^Qhhf, Hh^Fms, Hh^Qhhf, Hh^Qhhf, Gs, Hh^Qhh, Gg, Hh, Gg, Gg, Gg, Hh, Hh, Hh, Hh^Fds, Hh^Fds, Hh^Fds, Hh^Fds, Hh^Qhh, Hh^Qhh, Ds, Ds, Ds, Wwg, Wwg^Bw/r, Wwg^Bw/r
Hh^Qhhf, Hh^Fds, Gg, Gg, Gg^Fds, Gg^Fds, Gs^Qhh, Gg, Hh^_mhh, Hh, Hh^Qhh, Hh, Hh^Qhh, Hh^Qhhf, Hh, Hh^Qhhf, Gg, Gg, Gg, Gg, Gg^Fds, Gg^Fds, Gg, Gg, Hh, Hh, Hh^Qhh, Hh, Hh^Qhh, Hh^Qhhf, Hh^Qhhf, Hh^Qhhf, Gg^Fds, Gg, Ds, Ds, Rb, Re, Wwg, Wwg
Hh^Qhh, Hh, Gg, Gg, Gg, Gg^Qhh, Gg^Qhh, Hh^Qhh, Hh^Qhh, Hh^Qhh, Gs^Vh, Hh^Qhh, Gs, Gs, Gg^Efm, Gs, Gg, Gg, Hh^Fds, Hh^Fds, Gg^Fds, Gg, Gg^Qhh, Hh^Qhh, Hh^Qhh, Hh^Qhh, Hh, Hh^Qhh, Gg, Gg^Fds, Gs^Fds, Gg^Fds, Gs, Gs, Gs, Re, Re, Gs, Wwg, Wwg
Gg^Qhh, Gg, Hh^Qhh, Hh^Qhh, Hh^Qhh, Hh^Qhh, Gs^Efm, Gs, Gg^Efm, Gs, Gg^Efm, Gs, Gg^Efm, Gg^Efm, Gg^Efm, Gg^Efm, Gg^Fds, Hh^Fds, Hh, Hh^Fds, Hh, Hh, Gg^Fds, Gg^Fds, Gg, Gg, Gs, Gs, Gs^Fds, Gg^Fds, Gs^Qhh, Gs^Qhh, Re, Re, Gs, Rb, Gg^Fms, Gs^Qhh, Gg^Qhh, Wwg^Qhh
Gg^Qhh, Hh^Qhh, Gg, Gg^Efm, Gg, Gs^Efm, Gs, Gg, Gg, Gg^Efm, Hh, Gg^Efm, Gg^Efm, Gg^Efm, Gg^Efm, Gg^Efm, Gs, Hh, Gg, Hh^Fds, Gg^Fds, Gg^Fds, Gg, Gg, Gg^Qhh, Gg, Gg, Gg, Gg^Qhh, Gs^Qhh, Gs, Gs, Re, Gs, Gs, Gs^Fms, Gs^Qhhf, Gs^Qhhf, Hh, Ds^Qhh
Gg, Gg, Gg^Fds, Gg^Fds, Gg, Gg, Hh, Hh, Hh^Fds, Hh, Gs^Fds, Gs, Gg^Efm, Gg^Efm, Gg^Efm, Gg^Efm, Gs, Gs, Gg^Efm, Gg, Gg, Gg, Gg^Efm, Gg^Qhh, Wot, Gg^Qhh, Gg^Qhh, Gs^Qhh, Gg, Gs, Rb, Gg, Gs, Gs, Gs, Gs^Qhhf, Hh^Fds, Hh^_mhh, Gg^Fds, Hh^Fds
Gg^Fds, Gg^Fds, Hh, Hh, Hh, Hh^Fms, Hh^Fms, Hh^Fds, Hh^Fds, Gs^Fds, Gs, Gs, Gs, Gg^Efm, Gs^Efm, Gs^Efm, Gg^Efm, Gg^Efm, Gg^Qhh, Gg^Efm, Gg^Efm, Gg^Efm, Gg, Gg^Qhh, Wot, Wot, Wot, Gg^Qhh, Gg, Rb, Rb, Gg, Gg, Gs^Fms, Gg^Qhhf, Gs^Qhhf, Hh, Hh^Fds, Gg, Gs^Qhh
Gg, Hh, Hh, Hh, Hh, Gs^Vl, Hh, Hh^Fds, Hh^Fds, Hh, Gs^Fds, Gs^Fds, Gg, Gg, Gs^Efm, Gg^Efm, Gg^Qhh, Gg^Qhh, Ww, Gg^Qhh, Gg^Qhh, Gg, Gg^Qhh, Gg^Qhh, Wwt, Wwt, Wwt, Gg^Qhh, Gg^Qhh, Re, Gg, Gg, Gg, Gg^Fds, Gg^Qhhf, Hh, Gg, Gg^Efm, Gg^Efm, Hh^Qhh
Gg, Hh, Gg, Hh, Hh, Hh, Hh^Fds, Hh^Fds, Gg^Fds, Gs^Fds, Gg^Qhh, Gs, Gg, Gs, Gg^Qhh, Gg^Qhh, Ww, Ww, Ww, Ww, Ww, Gg^Qhh, Ww, Ww, Ww, Wwt, Wwt, Wwt, Gg^Qhh, Rb, Gg, Gg^Fds, Gg^Fds, Gg, Gg^Efm, Gg^Qhh, Gg^Qhh, Gg^Efm, Gg^Fds, Gg^Qhh
Gg, Gg, Hh^Fds, Hh^Fds, Hh^Fds, Hh^Fds, Gg, Gg, Gg^Qhh, Gg^Qhh, Wwg, Gg^Qhh, Gg^Qhh, Gg^_mh, Gg^Qhh, Ww, Ww, Ww, Gg^Ve, Ww, Ww, Ww, Ww, Ww, Ww, Wwt, Wwt, Gg^Fds, Gg, Re, Gg, Gg^Fds, Gs^Vl, Gg, Gg^Efm, Gg^Efm, Gg^Qhh, Gg, Gg^Fds, Hh^Qhh
Hh^Fds, Hh^Fds, Hh^Fds, Hh^Fds, Gg, Gg^Fds, Gg^Qhh, Gg^Qhh, Ds, Ds, Wwg, Wo, Wo, Gg^Qhh, Ww, Ww, Ww, Wwt, Gg, Wwt, Ww, Ww, Wwt, Wwt, Wwt, Wwt, Gg^Fds, Gg, Rb^Ii, Gg, Gg^Fds, Gg^Fds, Gs^Fms, Gg, Gg, Gg^Qhhf, Gg^Fds, Gg^Fds, Gg^Fds, Gg^Qhh
Gg, Hh, Hh, Hh, Hh, Gg, Gg^Qhh, Ds, Ds, Ww, Wo, Wo, Wo, Wo, Ww, Ww, Wwt, Gg^Fet, Wwt, Wwt, Wwt, Wwt, Gg^Fds, Gg^Fet, Wwt, Wwt, Gg, Gg, Re, Re, Gg, Gg^Fds, Gs^Fms, Gg, Gg^Fds, Gg^Qhhf, Gg^Qhhf, Hh^Fds, Hh, Hh^Qhh
Hh^Fds, Hh^Fds, Hh^Fds, Hh^Fds, Gg^Fds, Gg^Qhh, Ds, Ds, Wwt, Ww, Ww, Ww, Ww, Ww, Wwt, Ww, Cv, Wwt, Gg, Wwt, Wwt, Wwt, Wwt, Wwt, Gg, Gg^Ii, Gg^Ve, Gg, Wwt^Qhu, Gg, Wwt^Qhu, Gg, Gs^Fms, Gs^Fms, Gs^Fms, Gg^Fds, Hh^Qhhf, Hh^Fds, Gg^Efm, Hh^Qhh
Gg^Fds, Hh^Fds, Gg, Gg^Fds, Gg^Qhh, Gg^Qhh, Ds, Wwt, Ww, Ww, Ww, Ww, Ds, Ds, Wwt^Ii, Cv, Kv, Cv, Gg^Fds, Gg^Fds, Gg, Cv, Cv^Ii, Gg^Efm, Gg^Fds, Gg^Fds, Wo^Qhu, Wo^Qhu, Gg^Fds, Wwt^Qhu, Wwt, Wwt^Qhu, Gs^Fms, Gs^Fms, Gs^Fms, Hh^Fds, Hh^Fds, Gg^Qhhf, Gg^Qhh, Gg^Qhh
Gg, Gg, Gg^Fds, Gg^Fds, Gg, Gg, Gg, Wwt, Wwt, Ww, Wwt, Ww, Wwt, Wwt, Gg^Ve, Gg, Gg^Ii, Gg^Ii, Gg^Fds, Gg^Fds, Gg^Efm, Gg^Ve, Gg^Efm, Gg^Efm, Gg, Gg, Wwt^Qhu, Ww, Ww, Ww, Ww, Wwt^Qhu, Wwt^Qhu, Gg^Fds, Gg^Fds, Gg^Fds, Gs^Fms, Gg^Efm, Gg^Efm, Gg^Qhh
Gg, Gg^Fds, Gg, Gg, Gg^Efm, Gg, Gg, Wwt, Wwt, Wwt, Gg^Fet, Wwt, Wwt, Cv, Gg^Efm, Gg^Efm, Gg^Efm, Gd^Ve, Gg, Gg^Efm, Gg^Fds, Gg^Fds, Rrc^Ii, Gg, Wwt^Qhu, Wwt^Qhu, Wwt, Wwt, Wwt, Ww, Ww, Wwt, Wwt, Ds^Qhu, Gg, Gg^Fds, Gd, Gs, Gs, Gs
Gg^Efm, Gg, Gg^Efm, Gg^Efm, Gg^Efm, Gg^Efm, Gg, Wwt, Wwt, Wwt, Wwt, Wwt, Ds, Gg, Gg^Efm, Gg^Ve, Gg^Efm, Gg, Kv, Gg^Ve, Gg, Gg^Fds, Gg, Gg, Wwt^Qhu, Wwt, Gg^Fet, Gg, Ww, Ww, Ww, Wwt, Wwt^Qhu, Ds^Qhu, Gs^Fds, Gs^Fds, Hh, Hh, Hh, Hh
Gg, Gg^Efm, Gg, Gg, Gs^Vhr, Gg, Gg, Gg, Gs, Wwt, Gg^Ii, Ds, Gg^Fds, Gg^Efm, Gg^Ii, Gg^Efm, Gg, Gg^Ii, Cv^Ii, Cv, Wo^Qhu, Wo^Qhu, Ww^Qhu, Ww^Qhu, Wwt, Ww^_ml, Ww, Ww, Ds, Ww, Wwt, Wwt, Ds^Qhu, Gg^Fds, Hh^Fds, Hh, Hh^Fds, Hh, Gg^Fds, Gg^Fds
Hh^Fds, Gg, Hh^Fds, Gg^Fms, Hh^Fms, Gg, Hh, Re, Re, Gg, Gg^Fds, Gg^Ve, Wo^Qhu, Wo^Qhu, Wo^Qhu, Gg, Gg, Cv^Ii, Gg^Ve, Ds^Qhu, Ww, Wo^Ii, Wwt, Ww, Ww, Ww, Ds^Qhu, Ds^Qhu, Ds^Qhu, Ww, Ww, Wwt, Ds^Qhu, Hh^Fds, Hh^Fds, Hh^Fds, Gg^Fds, Gg^Fds, Gg^Fds, Gg
Hh, Hh^Fds, Hh^Fds, Hh^Fms, Hh, Hh, Gs, Gs, Gg, Gg, Wo^Qhu, Wo^Qhu, Ww, Wo^Qhu, Ww, Wo^Qhu, Ww^Qhu, Ww^Qhu, Ww^Qhu, Ww^Qhu, Ww, Ww, Gg^Fds, Gg^Ve, Ww, Ww, Ds^Qhu, Gg, Gg, Ds^Qhu, Ds^Qhu, Ds^Qhu, Hh, Hh, Hh, Gs, Gg, Hh^Fds, Gs^Qhh, Gg^Qhh
Gg, Gg^Fds, Gg, Hh, Hh, Gs, Gg, Gg^Fds, Gg^Fds, Wo^Qhu, Wo, Ww, Ww, Ww, Ww, Gg^Fet, Ww, Ww^Qhu, Ww, Ww, Ww, Ww, Ww, Gg^Fet, Ww, Ds^Qhu, Ds, Gg, Gg, Ds, Gg, Ds, Gg, Hh^Edt, Gg, Gg, Gg^Efm, Gs, Hh^Qhh, Hh^Qhh
Hh, Hh, Hh, Hh^Edt, Gg^Fds, Gg^Efm, Gg, Gg^Fds, Gs, Wo^Qhu, Wo^Qhu, Wwg, Wwg, Ww, Ww, Ww, Ww, Ww, Gg^Fds, Gg^Fds, Ww, Ww, Gs, Ww, Gg, Gg, Gg^Fms, Gg, Gg^Fds, Gg^Fds, Gs, Gs, Gg^Qhhf, Gg, Gg^Efm, Gg^Efm, Gg^Qhh, Hh^Qhh, Hh, Hh^Qhh
Gg^Fds, Gg^Fds, Hh, Gg, Gg, Gg^Efm, Gg^Efm, Gg, Gg, Gg, Gg, Wwg, Wwg, Wwg, Ww, Ww, Ww, Ww, Ww, Ww, Ww, Gs, Gg, Gs, Gg, Gg^Fms, Gg, Gs, Hh^Qhh, Hh^Qhh, Hh^Qhhf, Hh^Qhhf, Gg, Gg^Qhh, Gg^Qhh, Gg^Efm, Hh^Qhh, Hh, Hh^Fds, Hh^Qhhf
Hh, Hh, Gg^Fds, Gs^Fdw, Gg^Fds, Gg^Efm, Gg^Efm, Gg^Efm, Gg^Efm, Gg, Gg, Gs, Wwg, Wwg, Wwg, Ww, Ww, Ww, Ww, Ww, Gs, Gs, Gg, Gg, Gg, Gg, Gg, Hh^Qhh, Hh, Hh, Hh^Fds, Gs, Gg^Efm, Gg, Hh, Hh^Qhh, Hh^Fds, Hh^Fds, Gg^Fds, Gg^Qhhf
Ds, Gg^Fds, Ds, Gg^Fds, Gg, Gg, Gg, Gg^Efm, Hh, Gg, Hh, Gs, Gs, Wwg, Wwg, Wwg, Wwg, Ww, Wwg, Gg, Gs, Gg, Gg^Fds, Gg, Gg, Gg, Hh^Qhhf, Hh^Qhhf, Hh, Hh, Gg, Gs^Efm, Gs, Hh, Hh^Fds, Hh^Fds, Gg, Gg^Efm, Gg, Gg^Qhh
Ds, Ds, Ds, Gg^Fds, Hh, Hh, Hh, Hh, Hh, Hh^Edt, Hh, Gg, Gg^Efm, Gg, Gg, Wwg, Gg, Wwg, Gg, Gs, Gg, Hh^Fds, Hh^Qhhf, Gg, Hh^Qhh, Hh^Qhh, Gg^Vl, Hh, Hh^Fds, Gg^Fds, Gg^Fds, Gg^Efm, Gg, Hh, Gg^Fds, Hh^Fds, Gg, Gg, Hh, Gg^Qhh
Ds, Ds, Ds, Gs, Gg^Fds, Hh, Gg^Fds, Gg^Fds, Gg^Fds, Gg^Fds, Gg^Efm, Gg^Efm, Gg^Efm, Gg^Efm, Gg, Gg, Gg, Gg, Gg, Gg, Hh^Qhh, Hh^Qhhf, Hh^Qhh, Gg^Qhhf, Hh^Fds, Hh, Hh, Hh, Gg^Fds, Gg^Fds, Hh^Fds, Gg, Gg, Gg, Gg, Gg, Gg^_mh, Gs, Hh^Fds, Hh^Qhhf
Ds, Ds, Ds, Ds, Ds, Gg, Gg, Gg, Gg, Gg, Gg, Gg^Efm, Gg^Fds, Gg, Hh, Gg^Fds, Hh, Hh^Fds, Gg, Gg, Gg^Qhh, Hh^Qhh, Hh^Qhhf, Hh^Qhhf, Hh^Qhh, Hh^Qhh, Hh^Qhh, Gg^Qhhf, Hh^Qhhf, Hh^Qhhf, Hh^Qhhf, Hh^Qhh, Gg^Qhh, Gg^Qhhf, Gg^Qhhf, Gg^Qhhf, Gg^Qhhf, Hh^Qhhf, Hh^Qhhf, Hh^Qhhf
