Gg^Qhh, Gg^Qhh, Gg^Qhh, Gg^Qhh, Gg^Qhhf, Gg^Qhh, Gg^Qhh, Gg^Qhh, Gg^Qhh, Gg^Qhh, Gg^Qhh, Gg^Qhh, Hh^Qhhf, Hh^Qhh, Hh, Hh, Hh, Hh, Hh, Gg^Qhh, Hh^Qhh, Hh^Qhh, Gg^Qhh, Gg, Gg^Fds, Gg^Fds, Gg^Fds, Gg, Hh, Hh, Hh, Gg, Hh, Hh^Fds, Hh^Fds, Ds, Wwg, Wwg, Ds, Ds
Gg^Qhhf, Gg, Hh^Fds, Hh^Fds, Hh, Gg, Hh, Gg, Gg, Gg, Gs^Fds, Hh^Fds, Gs, Hh, Hh^Fds, Hh^Fds, Hh^Fds, Hh^Fds, Hh^Qhh, Hh, Hh^Qhh, Hh^Qhh, Hh^Fds, Hh^Fds, Gg, Gg^Fds, Hh, Hh, Hh, Hh, Hh^Fds, Hh^Fds, Hh^Fds, Hh^Fds, Gg, Ds, Wwg, Wwg, Wwg, Gs
Hh^Qhhf, Hh^Fds, Hh^Fds, Hh^Fds, Hh^Fds, Hh, Gg^Fds, Gg^Fds, Gs, Gg^Fds, Hh, Gg^Fdw, Hh^Fdw, Hh^Fds, Hh^Qhhf, Hh^Fds, Hh^Qhhf, Hh^Qhhf, Gs, Hh^Qhh, Gs, Hh, Gg, Gg, Gg, Hh, Hh, Hh, Hh^Fds, Hh^Fds, Hh^Fds, Hh^Fds, Hh^Qhh, Hh^Qhh, Ds, Ds, Ds, Wwg, Wwg^Bw/r, Wwg^Bw/r
Hh^Qhhf, Hh^Fds, Gg, Gg, Gg^Fds, Gg^Fds, Gs^Qhh, Gg, Hh^_mhh, Hh, Hh^Qhh, Hh, Hh^Qhh, Hh^Qhhf, Hh^Edt, Hh^Qhhf, Gd, Gs, Gs, Gs, Gg^Fds, Gg^Fds, Gg, Gg, Hh, Hh, Hh^Qhh, Hh, Hh^Qhh, Hh^Qhhf, Hh^Qhhf, Hh^Qhhf, Gg^Fds, Gg, Ds, Ds, Rb, Re, Wwg, Wwg
Hh^Qhh, Hh, Gg, Gg, Gg, Gg^Qhh, Gg^Qhh, Hh^Qhh, Hh^Qhh, Hh^Qhh, Gd^Vhr, Hh^Qhh, Gs^Edt, Gs, Gd^Edt, Gd, Gs, Gs^Edt, Hh^Fds, Hh^Fds, Gg^Fds, Gg, Gg^Qhh, Hh^Qhh, Hh^Qhh, Hh^Qhh, Hh, Hh^Qhh, Gg, Gg^Fds, Gs^Fds, Gg^Fds, Gs, Gs, Gs, Re, Re, Gs, Wwg, Wwg
Gg^Qhh, Gg, Hh^Qhh, Hh^Qhh, Hh^Qhh, Hh^Qhh, Gs^Efm, Gs, Gd, Gd, Gd, Gd, Gd, Gs, Gd, Gs, Gg^Fdw, Hh^Fdw, Hh, Hh^Fds, Hh, Hh, Gg^Fds, Gg^Fds, Gg, Gg, Gs, Gs, Gs^Fds, Gg^Fds, Gs^Qhh, Gs^Qhh, Re, Re, Gs, Rb, Gg, Gs, Gg^Fds, Wwg
Gg^Qhh, Hh^Qhh, Gg, Gg^Efm, Gg, Gs^Efm, Gs, Gs, Gs, Gs^Edt, Hh, Gd, Gd^Edt, Gd, Gd, Gs, Gs, Hh, Gg, Hh^Fds, Gg^Fds, Gg^Fds, Gg, Gg, Gg^Qhh, Gg, Gg, Gg, Gg^Qhh, Gs^Qhh, Gs, Gs, Re, Gs, Gs, Gs, Gs^Fds, Gs^Fds, Hh, Ds
Gg, Gg, Gg^Fds, Gg^Fds, Gg, Gg, Hh, Hh, Hh^Fdw, Hh, Gd^Fdw, Gs, Gs, Gd^Edt, Gd, Gs, Gs, Gs, Gg^Efm, Gg, Gg, Gg, Gg^Efm, Gg^Qhh, Wwt, Gg^Qhh, Gg^Qhh, Gs^Qhh, Gg, Gs, Rb, Gg, Gs, Gs, Gg^Fds, Gs, Hh^Fds, Hh, Gg^Fds, Hh^Fds
Gg^Fds, Gg^Fds, Hh, Hh, Hh, Hh^Fds, Hh^Fds, Hh^Fds, Hh^Fds, Gs^Fdw, Gs, Gs, Gd, Gd, Gs^Efm, Gs^Efm, Gg^Efm, Gg^Efm, Gg^Qhh, Gg^Efm, Gg^Efm, Gg^Efm, Gg, Gg^Qhh, Wwt, Wwt, Wwt, Gg, Gg, Rb, Rb, Gg, Gg, Gs, Gg, Gg^Fds, Hh, Hh^Fds, Gs, Gs
Gg, Hh, Hh, Hh, Hh, Gs^Vl, Hh, Hh^Fds, Hh^Fds, Hh, Gs^Fdw, Gs^Fdw, Gs, Gg, Gs^Efm, Gg^Efm, Gg^Qhh, Gg^Qhh, Ww, Gg^Qhh, Gg^Qhh, Gg, Gg^Qhh, Gg^Qhh, Wwt, Wwt, Wwt, Gg, Gg, Re, Gg, Gg, Gg, Gs, Gg, Hh, Gg, Gs, Gs, Hh
Gg, Hh, Gg, Hh, Hh, Hh, Hh^Fds, Hh^Fds, Gg^Fds, Gs^Fds, Gg^Qhh, Gs, Gg, Gs, Gg^Qhh, Gg^Qhh, Ww, Ww, Ww, Ww, Ww, Gg^Qhh, Ww, Ww, Ww, Wwt, Wwt, Wwt, Gg, Rb, Gg, Gg^Fds, Gg^Fds, Gg^Fds, Gg, Gg, Gg^Efm, Gg, Gg^Fds, Gg
Gg, Gg, Hh^Fds, Hh^Fds, Hh^Fds, Hh^Fds, Gg, Gg, Gg^Qhh, Gg^Qhh, Wwg, Gg^Qhh, Gg^Qhh, Gg^_mh, Gg^Qhh, Ww, Ww, Ww, Gg^Ve, Ww, Ww, Ww, Ww, Ww, Ww, Wwt, Wwt, Wwt, Gg, Re, Gg, Gg^Fds, Gs^Vl, Gg, Gg^Efm, Gg^Efm, Gg, Gg, Gg^Fds, Hh^Fds
Hh^Fds, Hh^Fds, Hh^Fds, Hh^Fds, Gg, Gg^Fds, Gg^Qhh, Gg^Qhh, Ds, Ds, Wwg, Wo, Wo, Gg^Qhh, Ww, Ww, Ww, Wwt, Gg, Wwt, Ww, Ww, Wwt, Wwt, Wwt, Wwt, Wwt, Gg, Re, Gg, Gg^Fds, Gg^Fds, Gg, Gg, Gg, Gg, Gg^Fds, Gg^Fds, Gg^Fds, Gg
Gg, Hh, Hh, Hh, Hh, Gg, Gg^Qhh, Ds, Ds, Ww, Wo, Wo, Wo, Wo, Ww, Ww, Wwt, Gg^Fet, Wwt, Wwt, Wwt, Wwt, Gg^Fds, Gg^Fet, Wwt, Wwt, Gg, Gg, Gg, Gg, Gg, Gg, Gg, Gg, Gg^Fds, Gg, Gg^Fds, Hh^Fds, Hh, Hh
Hh^Fds, Hh^Fds, Hh^Fds, Hh^Fds, Gg^Fds, Gg^Qhh, Ds, Ds, Wwt, Ww, Ww, Ww, Ww, Ww, Wwt, Ww, Cvr, Wwt, Gg, Wwt, Wwt, Wwt, Wwt, Wwt, Gg, Gg, Gg^Ve, Gg, Wwt^Qhu, Gg, Wwt^Qhu, Gg, Gg, Gg, Gs, Gg^Fds, Hh^Fds, Hh^Fds, Gs, Hh
Gg^Fds, Hh^Fds, Gg, Gg^Fds, Gg^Qhh, Gg^Qhh, Ds, Wwt, Ww, Ww, Ww, Ww, Ds, Ds, Wwt, Cvr, Kvr, Cvr, Gg^Fds, Gg^Fds, Gg, Cvr, Cvr^Dr, Gg, Gg^Fds, Gg^Fds, Wo^Qhu, Wo^Qhu, Ww, Wwt^Qhu, Wwt, Wwt^Qhu, Gg, Gs, Gs, Hh^Fds, Hh, Cer^Edt, Gd, Gs
Gg, Gg, Gg^Fds, Gg^Fds, Gg, Gg, Gg, Wwt, Wwt, Ww, Wwt, Ww, Wwt, Wwt, Gg, Gg, Gg, Gg, Gg^Fds, Gg^Fds, Gg, Gg^Ve, Gg, Gg, Gg, Gg, Wwt^Qhu, Ww, Ww, Ww, Ww, Wwt^Qhu, Wwt^Qhu, Gg, Gg, Gs, Gd, Gs, Cer^Edt, Gd
Gg, Gg^Fds, Gg, Gg, Gg^Efm, Gg, Gg, Wwt, Wwt, Wwt, Gg^Fet, Wwt, Wwt, Cvr, Gg^Efm, Gg^Ve, Gg^Efm, Gg, Gg, Gg, Gg^Fds, Gg^Fds, Gg^Fds, Gg, Wwt^Qhu, Wwt^Qhu, Wwt, Wwt, Wwt, Ww, Ww, Wwt, Wwt, Ds^Qhu, Gs, Gd^Fdw, Gd, Cer^Edt, Ker, Cer^Edt
Gg^Efm, Gg, Gg^Efm, Gg^Efm, Gg^Efm, Gg^Efm, Gg, Wwt, Wwt, Wwt, Wwt, Wwt, Ds, Gg, Gg^Efm, Gg^Efm, Gg^Efm, Gg, Kvr, Gg, Gg, Gg^Fds, Gg, Gg, Wwt^Qhu, Wwt, Gg^Fet, Gg, Ww, Ww, Ww, Wwt, Wwt^Qhu, Ds^Qhu, Gs^Fds, Gd^Fdw, Hh, Hh, Hh, Hh
Gg, Gg^Efm, Gg, Gg, Gs^Vhr, Gg, Gg, Gg, Gg^Fds, Wwt, Gg, Ds, Gg^Fds, Gg^Efm, Gg, Gg^Efm, Gg, Gg, Cvr, Cvr^Dr, Wo^Qhu, Wo^Qhu, Wo^Qhu, Wo^Qhu, Wwt, Ww^_ml, Ww, Ww, Ds, Ww, Wwt, Wwt, Ds^Qhu, Gg^Fds, Hh^Fds, Hh, Hh^Fds, Hh, Gg^Fds, Gg^Fds
Hh^Fds, Gg, Hh^Fds, Gg^Fds, Hh^Fds, Gg, Hh, Gg^Fds, Gg^Fds, Gg, Gg^Fds, Gg^Ve, Wo^Qhu, Wo^Qhu, Wo^Qhu, Gg, Gg, Cvr, Gg^Ve, Ds^Qhu, Wo^Qhu, Wo^Qhu, Wwt, Ww, Ww, Ww, Ds^Qhu, Ds^Qhu, Ds^Qhu, Ww, Wwt^Edt, Wwt, Ds^Qhu, Hh^Fds, Hh^Fds, Hh^Fds, Gg^Fds, Gg^Fds, Gg^Fds, Gg
Hh, Hh^Fds, Hh^Fds, Hh^Fds, Hh, Hh, Gs, Gs, Gg, Gg, Wo^Qhu, Wo^Qhu, Ww, Wo^Qhu, Ww, Wo^Qhu, Ww^Qhu, Ww^Qhu, Ww^Qhu, Ww^Qhu, Ww, Ww, Gg^Fds, Gg^Ve, Ww, Ww, Ds^Qhu, Gg, Gg, Ds^Qhu, Ds^Qhu, Ds^Qhu, Hh, Hh, Hh, Gs, Gg, Hh^Fds, Gs, Gg
Gg, Gg^Fds, Gg, Hh, Hh, Gs, Gd, Gs^Edt, Gs, Wo^Qhu, Wo, Ww, Ww, Ww, Ww, Gg^Fet, Ww, Ww^Qhu, Ww, Ww, Ww, Ww, Ww, Gg^Fet, Ww, Ds^Qhu, Ds, Gg, Gg, Ds^Edt, Gg, Ds, Gg, Hh^Edt, Gg, Gg, Gg^Efm, Gs, Hh, Hh
Hh, Hh, Hh, Hh^Edt, Gg^Fdw, Gd, Gd^Edt, Gs^Edt, Gs, Wo^Qhu, Wo^Qhu, Wwg, Wwg, Ww, Ww, Ww, Ww, Ww, Gg^Fds, Gg^Fds, Ww, Ww, Gs, Ww, Gs, Gs, Gd^Fdw, Gg, Gg^Fds, Gg^Fds, Gs, Gs^Edt, Gs^Fdw, Gg, Gg^Efm, Gg^Efm, Gg, Hh^Edt, Hh, Hh
Gg^Fds, Gg^Fds, Hh, Gs^Edt, Cer^Edt, Gd^Edt, Gd^Edt, Gs, Gd, Gs^Edt, Gs^Edt, Wwg, Wwg, Wwg, Ww, Ww, Ww, Ww, Ww, Ww, Ww, Gs, Gd^Edt, Gs, Gd, Gd^Fdw, Gd, Gs, Hh, Hh, Hh^Fds, Hh^Fds, Gg, Gg, Gg^Efm, Gg^Efm, Hh, Hh, Hh^Fds, Hh^Fds
Hh, Hh, Gs^Fdw, Gs^Fdw, Gd^Fdw, Gd^Edt, Cer^Edt, Gd, Gd^Edt, Gd^Edt, Gg, Gs, Wwg, Wwg, Wwg, Ww, Ww, Ww, Ww, Ww, Gs, Gs, Gd^Edt, Cer^Edt, Gd, Cer^Edt, Cer^Edt, Hh, Hh^Edt, Hh, Hh^Fds, Gs, Gg^Efm, Gg, Hh, Hh^Edt, Hh^Fds, Hh^Fds, Gg^Fds, Gg^Fds
Gg, Gg^Fds, Gs^Fds, Gd^Fdw, Gd^Edt, Ker, Cer^Edt, Gd, Hh, Gs^Edt, Hh, Gs, Gs, Wwg, Wwg, Wwg, Wwg, Ww, Wwg, Gg, Gs, Gd, Gg^Fds, Gd, Cer^Edt, Ker, Hh^Fds, Hh^Fds, Hh, Hh, Gg, Gs^Efm, Gs, Hh, Hh^Fds, Hh^Fds, Gg, Gg^Efm, Gg, Gg
Gg^Fds, Gg^Fds, Gg^Fds, Gs^Fdw, Hh, Hh^Edt, Hh^Fdw, Hh, Hh, Hh^Edt, Hh, Gg, Gg^Efm, Gg, Gg, Wwg, Gg, Wwg, Gg, Gs, Gg, Hh^Fds, Hh^Fds, Gd^Edt, Hh, Hh, Gg^Vl, Hh, Hh^Fds, Gg^Fds, Gg^Fds, Gg^Efm, Gs^Edt, Hh, Gg^Fds, Hh^Fds, Gg, Gg, Hh, Gg
Gg, Gg^Fds, Gg^Fds, Gs, Gg^Fds, Hh^Fdw, Gg^Fds, Gg^Fds, Gg^Fds, Gg^Fds, Gg^Efm, Gg^Efm, Gg^Efm, Gg^Efm, Gg, Gg, Gg, Gg, Gg, Gg, Hh, Hh^Fds, Hh^Fds, Gg^Fds, Hh^Fds, Hh, Hh, Hh, Gg^Fds, Gg^Fds, Hh^Fds, Gg, Gg, Gg, Gg, Gg, Gg, Gs, Hh^Fds, Hh^Fds
Gg, Gg^Fds, Gg, Gg, Gg^Fds, Gg, Gg, Gg, Gg, Gg, Gg, Gg^Efm, Gg^Fds, Gg, Hh, Gg^Fds, Hh, Hh^Fds, Gg, Gg, Gg, Gg, Hh^Fds, Hh^Fds, Hh, Hh, Hh, Gg^Fds, Hh^Fds, Hh^Fds, Hh^Fds, Hh, Gg, Gg^Fds, Gg^Fds, Gg^Fds, Gg^Fds, Hh^Fds, Hh^Fds, Hh^Fds
