Mm, Mm, Hh^Fmw, Mm, Hh^Fmw, Hh^Fp, Hh, Gg^Em, Gg^Efm, Re^Es, Re^Es, Gs^Fms, Gs^Fms, Gg^Fet, Gs^Fds, Gs^Fms, Gll^Emf, Gs^Fms, Re, Re^Es, Gs^Em, Re, Gs^Fp, Gg^Efm, Gg^Efm, Gg^Em, Gg^Fp, Gs^Em, Hh^Fms, Hh^Fms, Gg^Efm, Gg^Efm, Gg^Fp, Gg^Fp, Ww^Ewl, Gg^Efm
Hh^Fds, Mm, Mm, Hh^Fdw, Hh^Em, Hh^Fmw, Hh^Em, Hh^Fms, Hh^Fds, Gs^Fp, Gs^Fms, Re^Es, Gs^Fds, Gs^Fds, Gs^Fms, Gll^Em, Gs^Fp, Gs^Em, Re, Gs^Fp, Gg^Fmw, Gg^Efm, Hh^Fp, Hh^Fms, Gg^Em, Hh, Hh^Fms, Ww^Ewf, Ww, Ww^Ewf, Wwf, Gg^Fms, Gg^Fms, Gg^Fms, Ww^Ewl, Ww
Hh^Em, Hh^Fds, Gll^Fp, Hh^Fmw, Gs^Fms, Gll^Emf, Hh^Em, Mm, Hh^Fds, Gs^Fds, Gs^Fms, 1 Re^Es, Re^Es, Gs^Fms, Re, Re^Es, Re, Gs^Fmw, Re^Es, Gg^Fmw, Ww, Ww^Ewf, Hh^Fp, Hh^Fms, Hh^Fms, Hh^Fp, Hh^Fms, Ww^Ewf, Ww^Ewf, Ww, Gg^Fms, Wwf, Ww, Ww^Ewl, Ww, Ww^Ewl
Hh^Fp, Hh^Fms, Gll^Emf, Gll^Fp, Hh^Fms, Gs^Fms, Gs^Fms, Hh^Fms, Gll^Em, Gs^Em, Hh^Fds, Gs^Fds, Gg^Efm, Re, Gs^Fmw, Gs^Fp, Gs, Re, Gg^Efm, Ww^Ewf, Ww^Ewl, Ww, Gg^Fp, Hh, Gs^Fms, Hh^Fp, Hh^Fms, Gg^Fds, Gg^Efm, Ww, Gg^Fms, Gg^Efm, Ww, Ww, Gg^Fp, Ww^Ewl
Gs^Fms, Gs^Em, Gll^Fms, Hh^Fms, Hh^Fds, Hh^Fms, Gs^Em, Gll^Fds, Gll^Fp, Hh^Fms, Hh^Fms, Gs^Fms, Gs^Fms, Re, Gg, Gg^Efm, Gs^Ve, Re, Ww^Ewf, Ww, Ww^Ewf, Ww, Ww, Gs^Em, Gs^Fmw, Hh^Fp, Gg^Fms, Gg^Fms, Gs^Em, Ww, Hh, Ww^Ewf, Ww^Ewf, Ww^Ewf, Gg^Fp, Gg^Fp
Hh^Fms, Hh^Fms, Hh^Fms, Gll^Fds, Gll^Em, Gs^Fp, Gll^Em, Gll^Fms, Gg^Fmw, Hh^Fp, Gll^Emf, Hh^Fp, Gs^Fmw, Re, Gg^Efm, Gs^Fms, Hh^Fms, Rp, Gs^Fms, Gs^Fmw, Hh^Fmw, Hh, Ww, Ww, Ww, Gs^Em, Gg^Efm, Gg^Efm, Ww, Ww, Hh^Fp, Gg^Fms, Hh^Fms, Gg^Fms, Gs^Fms, Gs^Fms
Hh^Fp, Mm, Mm, Gs^Fp, Gg, Gg^Efm, Gs, Gll^Em, Gll^Em, Hh, Hh, Gll^Em, Rp, Rp, Hh, Gs^Fms, Gs^Fms, Rp, Rp, Gs^Fp, Gg^Efm, Hh, Gg^Efm, Ww, Ww, Gs^Em, Gg, Gg, Ww, Gs^Fmw, Gs^Fp, Gs^Fds, Gs^Fms, Hh^Fds, Gs^Em, Gg^Efm
Hh^Fp, Mm, Hh^Es, Hh^Es, Re, Gs, Hh^Es, Hh^Es, Gs^Es, Gs, Gg^Efm, Gs, Rp, Gg^Efm, Gg^Vc, Hh^Fms, Rp, Rp, Mm, Rp, Rp, Rp, Rp, Gg, Ww^Ewf, Ww, Ww, Gg^Efm, Ww, Gs^Fmw, Gs^Em, Gs^Fms, Gs^Fms, Gs^Fds, Gg^Efm, Gs^Fds
Re, Re, Re^Es, Re^Es, Hh^Es, Re, Re, Gs^Es, Gg^Efm, Gs^Em, Gs, Gg^Efm, Rp, Rp, Rp, Rp, Hh^Fp, Hh^Fp, Hh, Hh, Gs^Em, Gs^Em, Wwf, Wwf^Bsb\, Rp, Ww, Cv, Ww, Ww, Gg^Efm, Gg^Efm, Gs^Fms, Gs^Fds, Gg^Em, Gs^Em, Gs^Fms
Hh^Fp, Hh^Es, Hh^Fp, Gs^Em, Hh^Fms, Hh^Fp, Gs^Es, Re, Cv, Kv, Cv, Rp, Wwf, Wwf, Ww^Ewl, Ww^Ewl, Mm, Mm, Mm, Mm, Ww, Hh^Fp, Ww, Gg, Rp, Cv, Kv, Ww, Gs^Fms, Gs^Fms, Gs^Fms, Gs^Fms, Gs^Fms, Gs^Fp, Gll^Emf, Gg^Fp
Mm, Mm, Hh^Fp, Gs^Em, Gll^Fdw, Gll^Fmw, Hh^Fmw, Re, Re^Es, Cv, Rp, Rp, Hh^Es, Hh^Es, Hh^Em, Ww^Ewl, Mm, Mm, Mm, Ww, Mm, Ww, Hh, Gg^Efm, Rp, Gg, Ww, Ww, Gs^Fds, Hh^Fds, Hh^Fms, Hh^Fms, Gg^Fp, Gs^Efm, Gs^Fms, Gs^Fms
Hh^Fp, Mm, Gll^Em, Gll^Em, Hh^Fp, Hh^Fmw, Hh, Gg, Gg, Re^Es, Re^Es, Wwf, Wwf, Gg^Vl, Gs^Fp, Ww, Ww, Hh^Fds, Gg^Fet, Mm, Hh^Fp, Hh, Gs^Fmw, Gg, Ww, Ww^Bsb\, Rp, Gg, Gs^Fds, Hh^Fds, Hh^Fms, Mm, Hh^Fds, Gg^Fp, Gs^Fms, Gs^Fp
Gs^Fms, Hh^Fp, Hh^Em, Gll^Em, Hh^Fp, Hh^Fp, Mm, Gg, Gg, Hh^Em, Re^Es, Wwf, Ww^Ewl, Ww, Ww, Hh^Em, Ww, Hh^Fms, Gg^Em, Hh^Fp, Hh^Fms, Ww^Ewl, Ww, Ww^Ewl, Ww, Rp, Gg^Fp, Rp, Gs^Em, Gll^Fms, Gg^Fms, Hh^Fds, Gll^Emf, Hh, Gs^Fms, Gs^Fp
Hh, Gll^Fmw, Gll^Fdw, Hh^Em, Hh^Fmw, Mm, Mm, Hh, Hh^Fmw, Mm, Re, Hh^Fp, Mm, Mm, Mm, Ww, Ww, Hh, Gs, Gg^Efm, Gs^Ve, Ww^Ewl, Ww, Ww^Ewf, Rp, Rp, Gs^Fms, Hh^Fms, Hh^Fms, Gs^Fms, Gs^Fds, Gs^Em, Hh^Es, Gs^Fp, Gs^Fms, Gs^Fds
Hh^Fp, Gll^Fmw, Hh, Hh^Es, Hh^Es, Mm, Mm, Mm, Hh^Fp, Hh^Fp, Re, Mm, Mm, Mm, Hh^Es, Gs^Fmw, Ww^Bsb/, Ww^Bsb/, Ww^Ewl, Gs, Ww, Ww, Ww^Ewf, Rp, Gs^Fp, Gs^Fp, Gs^Fms, Hh^Fds, Gll^Em, Gs^Fp, Gs^Fms, Hh^Fms, Hh^Em, Hh^Fms, Mm, Gs^Fms
Hh, Hh^Fp, Gs^Emf, Hh^Fdw, Gg^Em, Hh^Es, Hh^Em, Hh^Fms, Hh^Fp, Mm, Hh^Fp, Re, Hh^Es, Hh^Fmw, Re, Re^Es, Gs^Fp, Ww, Ww, Ww^Ewl, Gg^Ve, Gs^Fms, Gs^Fp, Rp, Hh^Fp, Hh^Es, Hh^Fms, Gs^Fms, Hh^Fp, Hh^Es, Hh^Em, Hh^Fms, Hh^Fp, Hh^Fds, Hh^Em, Hh^Fms
Hh^Fms, Gs^Fdw, Hh^Fp, Gg^Em, Mm, Mm, Mm, Gs^Fms, Gs^Fms, Hh^Fp, Gg^Efm, Re^Es, Re^Es, Re, Gg^Vl, Hh^Fp, Gg, Ww^Ewl, Ww^Ewl, Ww, Re, Gs, Re, Re, Hh, Mm, Mm, Hh^Fp, Hh^Em, Gll^Emf, Hh^Fp, Mm, Mm, Mm, Hh^Fms, Hh^Fds
Hh^Fds, Hh^Fp, Mm, Hh^Fds, Mm, Mm, Mm, Gg^Fet, Gs^Fds, Gs^Fms, Gg^Em, Re, Gs^Efm, Hh^Fp, Re, Gs^Fms, Re, Gg, Re, Wwf^Bsb/, Gs^Fmw, Re, Cvr, Kvr, Gll^Em, Gll^Fms, Gs^Fds, Hh^Es, Hh^Fp, Mm, Mm, Hh, Mm, Mm, Mm, Mm
Mm, Hh^Fms, Mm, Mm, Mm, Mm, Gs^Fp, Gs^Fds, Gs^Fms, Gg^Ve, Gs^Fp, Re, Re, Re, Gll^Emf, Re, Gg, Re, Gg, Wwf, Ww, Gs^Fp, Gs^Em, Hh^Fds, Gll^Emf, Gll^Fms, Gll^Fms, Gs^Fms, Mm, Hh^Fmw, Mm, Hh^Fp, Hh^Fmw, Mm, Mm, Mm
Mm, Mm, Mm, Mm, Hh^Fmw, Mm, Hh^Fp, Hh^Fms, Hh^Es, Gs^Fms, Gg^Efm, Gg^Efm, Re^Es, Hh^Fds, Hh, Hh, Mm, Hh^Fmw, Gg, Gll^Fms, Gs^Fms, Ww, Gs^Fp, Hh, Hh^Fds, Gs^Fds, Mm, Hh^Fp, Mm, Mm, Mm, Mm, Mm, Mm, Mm, Mm
Mm, Mm, Mm, Mm, Mm, Hh, Hh^Fp, Hh^Es, Hh^Fmw, Gs^Em, Gs^Fmw, Re, Gs^Fp, Gg^Vl, Hh^Fds, Mm, Mm, Hh, Gs^Fms, Gs^Fds, Hh^Fds, Ww, Gs^Fds, Gs^Fms, Hh, Hh^Fms, Mm, Mm, Mm, Hh^Fmw, Hh, Mm, Mm, Mm, Mm, Mm
Hh^Fmw, Hh^Fmw, Mm, Mm, Mm, Mm, Hh^Fp, Hh^Fp, Hh^Es, Hh^Es, Gll^Em, Re, Gll^Fmw, Gs^Fms, Gs^Fms, Gs^Fms, Hh^Em, Hh^Fp, Gll^Emf, Gs^Fms, Ww, Ww^Ewl, Ww^Ewl, Gs^Fds, Ww, Ww^Ewl, Ww, Mm, Mm, Mm, Hh, Hh^Fmw, Mm, Mm, Mm, Mm
Hh^Em, Mm, Hh^Fmw, Mm, Hh^Fp, Hh^Em, Gs^Fds, Gs^Fms, Hh^Em, Hh^Es, Re^Es, Cvr, Kvr, Hh^Fds, Gs^Fp, Hh^Fp, Hh^Fp, Hh^Em, Hh^Em, Ww^Ewl, Ww, Ww, Wo, Ww, Wo, Wo, Ww, Ww^Ewl, Hh^Fp, Mm, Hh^Fmw, Hh^Fmw, Mm, Mm, Mm, Mm
Hh^Fmw, Hh, Mm, Mm, Hh^Fds, Hh^Em, Gs^Fms, Gs^Fms, Gll^Em, Gs^Fmw, Re, Re, Hh^Es, Gs^Fms, Hh^Em, Hh^Emf, Hh^Fmw, Hh^Fmw, Wwf, Wwf, Ww, Wo, Wo, Wo, Wo, Ww, Hh^Fp, Ww^Ewl, Hh^Fp, Mm, Mm, Mm, Mm, Mm, Hh^Fmw, Hh
Ww, Ww, Ww, Hh^Fp, Hh^Fmw, Gs^Fp, Hh^Fmw, Hh^Fdw, Gs^Fdw, Re^Es, Hh^Fmw, Hh^Es, Hh^Fmw, Hh^Fmw, Mm, Mm, Mm, Ww^Ewl, Ww^Ewl, Ww, Wo, Wo, Wo, Wo, Ww, Ww, Wwf, Hh^Fms, Mm, Mm, Mm, Mm, Mm, Hh^Fp, Mm, Hh
Ww, Gg^Efm, Gs^Fp, Ww, Gll^Fmw, Gs^Fdw, Gs^Es, Gll^Em, Gs^Es, Re, Hh^Es, Mm, Hh, Hh, Hh^Fdw, Hh^Em, Mm, Ww^Ewl, Ww^Ewl, Wo, Wo, Wo, Ww, Ww, Ww, Wwf, Gg^Fms, Hh^Fds, Hh^Fp, Mm, Mm, Mm, Gll^Fp, Hh^Em, Mm, Mm
Hh^Fp, Gs^Fds, Gs^Fms, Wwf, Hh, Gd^Em, Re^Ecf, Re, Re, Re, Re^Es, Gll^Em, Gll, Mm, Hh^Fdw, Hh^Fmw, Mm, Mm, Ww, Wo, Wo, Ww, Ww, Ww^Ewl, Ww, Ww^Ewf, Gs^Fms, Gs^Fds, Hh^Em, Wwf, Ww^Ewl, Hh^Em, Gll^Emf, Mm, Mm, Hh
Ww^Ewf, Gg^Em, Wwf, Wwf, Re^Vct, Hh^Fdw, Gd^Es, Gd^Es, Gs^Fmw, Hh^Es, Hh^Es, Re^Es, Re^Es, Hh, Gll^Ve, Ww^Ewl, Wwf, Mm, Ww^Ewl, Ww, Ww, Ww, Ww, Ww, Ww^Bw\, Gg^Fds, Gg^Fet, Gg^Efm, Ww^Ewf, Ww, Ww, Gs^Fp, Hh^Fp, Hh^Em, Hh^Fmw, Hh^Fmw
Ww^Ewf, Ww, Ww, Hh^Fmw, Hh^Fmw, Gs, Gs^Fmw, Gs, Re, Mm, Mm, Hh^Es, Re, Gll^Em, Ww^Ewl, Ww, Ww, Wwf, Ww, Ww, Ww, Ww^Ewl, Ww, Ww^Ewf, Gg^Fet, Gg^Ve, Gg^Efm, Gs^Fms, Ww, Ww, Wo, Ww, Ww, Hh^Fp, Mm, Mm
Ww^Ewl, Ww, Hh^Fp, Gll^Fp, Hh^Fmw, Hh^Fmw, Hh, Hh^Fmw, Hh^Fmw, Hh^Fdw, Mm, Re, Mm, Hh^Fmw, Mm, Ww^Ewl, Mm, Ww, Ww, Ww, Ww, Ww, Ww^Ewl, Gs^Fds, Gs^Fms, Gg^Fms, Gs^Fms, Gs^Fds, Ww, Ww, Wo, Wo, Ww, Mm, Mm, Mm
Ww, Hh^Fms, Hh^Fms, Gll^Emf, Gll^Fp, Hh, Gll^Fmw, Hh^Fmw, Gd^Fmw, Hh^Es, Hh^Fdw, Re, Hh, Hh, Hh, Mm, Hh^Em, Hh^Em, Gs^Fms, Wwf, Gg^Efm, Ww^Ewf, Gg^Em, Gg^Efm, Gs^Fds, Gg^Em, Ww, Ww, Ww^Ewf, Wo, Wo, Wo, Ww, Hh, Mm, Mm
Ww, Ww, Ww, Hh^Fp, Wwf, Gll^Em, Gll^Fmw, Hh, Hh, Ww^Ewl, Ww, Ww^Bw|, Ww, Hh^Fds, Ww^Ewl, Hh, Ww, Ww, Ww, Wwf, Hh^Em, Gs^Fms, Gs^Fp, Ww^Ewf, Ww, Wwf, Ww, Ww, Wo, Wo, Wo, Ww, Hh^Fmw, Hh^Fmw, Mm, Mm
Hh, Ww^Ewl, Gs^Fp, Ww, Gs^Fmw, Wwf, Wwf, Ww, Ww, Ww, Ww, Wo^Bw|, Ww^Bw\r, Ww, Gs^Em, Ww, Rb, Hh^Fmw, Rb^Es, Hh^Fms, Rb^Es, Gll^Fp, Hh^Fds, Ww^Ewf, Gs^Fp, Hh^Fmw, Ww^Ewl, Ww, Wo, Wo, Wo, Ww, Ww, Mm, Mm, Mm
Gg^Efm, Hh^Fms, Gs^Fmw, Gs^Fmw, Re, Gs^Ve, Re^Es, Re, Re, Ww^Ewl, Gll^Fp, Ww^Ewl, Gll^Fp, Rb^Es, Rb, Rb, Gs^Em, Rb^Es, Gg^Efm, Rb^Es, Gg^Fp, Hh^Fp, Mm, Gs^Fms, Mm, Hh^Fp, Hh^Fmw, Ww^Ewl, Ww^Ewf, Ww, Wo, Wo, Ww, Ww^Ewl, Mm, Mm
Re^Es, Re, Re, Re^Es, Gs^Em, Re, Gs^Fms, Gs^Fmw, Gll^Fp, Re, Re, Gll^Fp, Re^Es, Rb, Ce^Vct, 2 Ce, Gs^Fp, Hh, Hh^Fms, Gs^Fms, Mm, Hh^Fmw, Mm, Hh^Fp, Ww, Ww, Ww^Ewl, Ww^Ewl, Ww^Ewl, Ww, Ww, Ww, Hh^Fmw, Hh^Fmw, Mm, Mm
Rb^Es, Gs^Fms, Gs^Fp, Gs^Fp, Gs^Em, Re, Gs^Fms, Gs^Fms, Gs^Fms, Gs, Re^Es, Re, Gll^Fmw, Gll^Fmw, Gll^Fp, Gs^Fms, Gs^Fms, Hh, Hh, Mm, Mm, Mm, Mm, Mm, Ww, Mm, Mm, Mm, Mm, Mm, Mm, Ww^Ewl, Mm, Mm, Mm, Mm
Hh, Gs^Fp, Hh, Hh^Fms, Gs^Fds, Gs^Fms, Hh, Gll^Emf, Gs^Em, Gs^Fmw, Gs^Fms, Gll^Fp, Hh^Fmw, Hh^Fms, Hh^Fmw, Hh, Mm, Hh^Fp, Hh^Fp, Mm, Mm, Mm, Mm, Wo, Mm, Mm, Hh^Fmw, Mm, Mm, Mm, Mm, Mm, Mm, Mm, Mm, Mm
Hh^Fds, Hh^Fms, Hh^Fds, Gs^Fms, Gs^Fds, Hh^Fp, Hh, Gs^Fds, Gs^Fms, Gs^Fms, Gs^Fds, Hh^Fp, Gs^Fms, Mm, Hh^Fds, Hh^Fds, Hh^Fds, Mm, Hh, Hh^Fmw, Hh, Mm, Mm, Wo, Mm, Mm, Hh, Hh, Hh, Mm, Mm, Hh, Hh, Hh^Fmw, Mm, Mm
