Gg^Qhh, Hh^Qhh, Gg, Gg^Efm, Gg, Gs^Efm, Gs, Gs, Gs, Gs^Edt, Hh, Gd, Gd^Edt, Gd, Gd, Gs, Gs, Hh, Gg, Hh^Fds, Gg^Fds, Gg^Fds, Gg, Gg, Gg^Qhh, Gg, Gg, Gg, Gg^Qhh, Gs^Qhh, Gs, Gs, Rb, Gs, Gs, Gs, Gs^Fds, Gs^Fds, Hh, Gg
Gg, Gg, Gg^Fds, Gg^Fds, Gg, Gg, Hh, Hh, Hh^Fdw, Hh, Gd^Fdw, Cer^Edt, Cer^Edt, Gd^Edt, Gd, Gs, Gs, Gs, Gg^Efm, Gg, Gg, Gg, Gg^Efm, Gg^Qhh, Wwt, Gg^Qhh, Gg^Qhh, Gs^Qhh, Gg, Gs, Rb, Gg, Gs, Gs, Gg^Fds, Gs, Hh^Fds, Hh, Gg^Fds, Hh^Fds
Gg^Fds, Gg^Fds, Hh, Hh, Hh, Hh^Fds, Hh^Fds, Hh^Fds, Hh^Fds, Gs^Fdw, Gs, Cer^Edt, Gd, Gd, Gs^Efm, Gs^Efm, Gg^Efm, Gg^Efm, Gg^Qhh, Gg^Efm, Gg^Efm, Gg^Efm, Gg, Gg^Qhh, Wwt, Wwt, Wwt, Gg, Gg, Rb, Rb, Gg, Gg, Gs, Gg, Gg^Fds, Hh, Hh^Fds, Gs, Gs
Gg, Hh, Hh, Hh, Hh, Gs^Vl, Hh, Hh^Fds, Hh^Fds, Hh, Gs^Fdw, Gs^Fdw, Gs, Gg, Gs^Efm, Gg^Efm, Gg^Qhh, Gg^Qhh, Ww, Gg^Qhh, Gg^Qhh, Gg, Gg^Qhh, Gg^Qhh, Wwt, Wwt, Wwt, Gg, Gg, Re, Gg, Gg, Gg, Gs, Gg, Hh, Gg, Gs, Gs, Hh
Gg, Hh, Gg, Hh, Hh, Hh, Hh^Fds, Hh^Fds, Gg^Fds, Gs^Fds, Gg^Qhh, Gs, Gg, Gs, Gg^Qhh, Gg^Qhh, Ww, Ww, Ww, Ww, Ww, Gg^Qhh, Ww, Ww, Ww, Wwt, Wwt, Wwt, Gg, Rb, Gg, Gg^Fds, Gg^Fds, Gg^Fds, Gg, Gg, Gg^Efm, Gg, Gg^Fds, Gg
Gg, Gg, Hh^Fds, Hh^Fds, Hh^Fds, Hh^Fds, Gg, Gg, Gg^Qhh, Gg^Qhh, Wwg, Gg^Qhh, Gg^Qhh, Gg^_mh, Gg^Qhh, Ww, Ww, Ww, Gg^Ve, Ww, Ww, Ww, Ww, Ww, Ww, Wwt, Wwt, Wwt, Gg, Re, Gg, Gg^Fds, Gs^Vl, Gg, Gg^Efm, Gg^Efm, Gg, Gg, Gg^Fds, Hh^Fds
Hh^Fds, Hh^Fds, Hh^Fds, Hh^Fds, Gg, Gg^Fds, Gg^Qhh, Gg^Qhh, Ds, Ds, Wwg, Wwg, Wwg, Gg^Qhh, Ww, Ww, Ww, Wwt, Gg, Wwt, Ww, Ww, Wwt, Wwt, Wwt, Wwt, Wwt, Gg, Re, Gg, Gg^Fds, Gg^Fds, Gg, Gg, Gg, Gg, Gg^Fds, Gg^Fds, Gg^Fds, Gg
Gg, Hh, Hh, Hh, Hh, Gg, Gg^Qhh, Ds, Ds, Ww, Wwg, Wwg, Ww, Ww, Ww, Ww, Wwt, Gg^Fet, Wwt, Wwt, Wwt, Wwt, Gg^Fds, Gg^Fet, Wwt, Wwt, Gg, Gg, Gg, Gg, Gg, Gg, Gg, Gg, Gg^Fds, Gg, Gg^Fds, Hh^Fds, Hh, Hh
Hh^Fds, Hh^Fds, Hh^Fds, Hh^Fds, Gg^Fds, Gg^Qhh, Ds, Ds, Wwt, Ww, Ww, Ww, Ww, Ww, Wwt, Ww, Cvr, Wwt, Gg, Wwt, Wwt, Wwt, Wwt, Wwt, Gg, Gg, Gg^Ve, Gg, Wwt^Qhu, Gg, Wwt^Qhu, Gg, Gg, Gg, Gg, Gg^Fds, Hh^Fds, Hh^Fds, Gg, Hh
Gg^Fds, Hh^Fds, Gg, Gg^Fds, Gg^Qhh, Gg^Qhh, Ds, Wwt, Ww, Ww, Ww, Ww, Ds, Ds, Wwt, Cvr, Kvr, Cvr, Gg^Fds, Gg^Fds, Gg, Cvr, Cvr^Dr, Gg, Gg^Fds, Gg^Fds, Wwt^Qhu, Wwt^Qhu, Ww, Wwt^Qhu, Wwt, Wwt^Qhu, Gg, Gg, Gg, Hh^Fds, Hh, Hh, Gg, Gg
Gg, Gg, Gg^Fds, Gg^Fds, Gg, Gg, Gg, Wwt, Wwt, Ww, Wwt, Ww, Wwt, Wwt, Gg, Gg, Gg, Gg, Gg^Fds, Gg^Fds, Gg, Gg^Ve, Gg, Gg, Gg, Gg, Wwt^Qhu, Ww, Ww, Ww, Ww, Wwt^Qhu, Wwt^Qhu, Gg, Gg, Gg, Gg, Gg, Gg, Gg
Gg, Gg^Fds, Gg, Gg, Gg^Efm, Gg, Gg, Wwt, Wwt, Wwt, Gg^Fet, Wwt, Wwt, Cvr, Gg^Efm, Gg^Ve, Gg^Efm, Gg, Gg, Gg, Gg^Fds, Gg^Fds, Gg^Fds, Gg, Wwt^Qhu, Wwt^Qhu, Wwt, Wwt, Wwt, Ww, Ww, Wwt, Wwt, Ds^Qhu, Gg, Gg^Fds, Gg, Gg, Gg, Gg
Gg^Efm, Gg, Gg^Efm, Gg^Efm, Gg^Efm, Gg^Efm, Gg, Wwt, Wwt, Wwt, Wwt, Wwt, Ds, Gg, Gg^Efm, Gg^Efm, Gg^Efm, Gg, Kvr, Gg, Gg, Gg^Fds, Gg, Gg, Wwt^Qhu, Wwt, Gg^Fet, Gg, Ww, Ww, Ww, Wwt, Wwt^Qhu, Ds^Qhu, Gg^Fds, Gg^Fds, Hh, Hh, Hh, Hh
Gg, Gg^Efm, Gg, Gg, Gs^Vhr, Gg, Gg, Gg, Gg^Fds, Wwt, Gg, Ds, Gg^Fds, Gg^Efm, Gg, Gg^Efm, Gg, Gg, Cvr, Cvr^Dr, Gg, Gg, Wwt^Qhu, Ww^Qhu, Wwt, Ww^_ml, Ww, Ww, Ds, Ww, Wwt, Wwt, Ds^Qhu, Gg^Fds, Hh^Fds, Hh, Hh^Fds, Hh, Gg^Fds, Gg^Fds
Hh^Fds, Gg, Hh^Fds, Gg^Fds, Hh^Fds, Gg, Hh, Gg^Fds, Gg^Fds, Gg, Gg^Fds, Gg^Ve, Wwg^Qhu, Ww^Qhu, Ww^Qhu, Gg, Gg, Cvr, Ww^Qhu, Ww^Qhu, Ww^Qhu, Wwt^Qhu, Wwt, Ww, Ww, Ww, Ds^Qhu, Ds^Qhu, Ds^Qhu, Ww, Wwt^Edt, Wwt, Ds^Qhu, Hh^Fds, Hh^Fds, Hh^Fds, Gg^Fds, Gg^Fds, Gg^Fds, Gg
Hh, Hh^Fds, Hh^Fds, Hh^Fds, Hh, Hh, Gs, Gs, Gg, Gg, Wwg^Qhu, Wwg^Qhu, Ww, Ww, Ww, Ww^Qhu, Ww^Qhu, Gg^Ve, Ww^Qhu, Ww, Ww, Ww, Gg^Fds, Gg^Ve, Ww, Ww, Ds^Qhu, Gg, Gg, Ds^Qhu, Ds^Qhu, Ds^Qhu, Hh, Hh, Hh, Gs, Gd^Fdw, Hh^Fds, Gs, Gg
Gg, Gg^Fds, Gg, Hh, Hh, Gs, Gd, Gs^Edt, Gs, Wwg^Qhu, Wwg, Ww, Ww, Ww, Ww, Gg^Fet, Ww, Ww^Qhu, Ww, Ww, Ww, Ww, Ww, Gg^Fet, Ww, Ds^Qhu, Ds, Gg, Gg^Fds, Ds^Edt, Gs^Edt, Ds, Gs^Edt, Hh^Edt, Gs, Gs^Fdw, Gs, Gs, Hh, Hh
Hh, Hh, Hh, Hh^Edt, Gg^Fdw, Gd, Gd^Edt, Gs^Edt, Gs, Wwg^Qhu, Wwg^Qhu, Wwg, Wwg, Ww, Ww, Ww, Ww, Ww, Gg^Fds, Gg^Fds, Ww, Ww, Gg, Ww, Gg^Fds, Gg^Fds, Gg, Gg^Fds, Hh, Gs, Hh^Fds, Gs^Fdw, Gs^Edt, Gs, Gs, Gd, Hh^Edt, Hh^Edt, Hh, Hh
Gg^Fds, Gg^Fds, Hh, Gs^Edt, Gs, Gd^Edt, Gd^Edt, Gs, Gd, Gs^Edt, Gs^Edt, Wwg, Wwg, Wwg, Ww, Ww, Ww, Ww, Ww, Ww, Ww, Gg, Gg, Gg^Fds, Gg^Fds, Gg^Fds, Hh, Hh, Hh, Hh^Fds, Gs, Gd, Gs^Edt, Gd, Gd, Gd, Hh, Hh, Hh^Fds, Hh^Fds
Hh, Hh, Gs^Fdw, Gs^Fdw, Gd^Fdw, Gd^Edt, Gs, Gd, Gd^Edt, Gd^Edt, Gg, Gs, Wwg, Wwg, Wwg, Ww, Ww, Ww, Ww, Ww, Gg, Gg, Gg, Gg, Gg, Hh^Fds, Hh^Fds, Hh^Edt, Hh, Hh^Fds, Gs^Efm, Gg^Efm, Gs, Gd^Edt, Hh, Hh^Edt, Hh^Fds, Hh^Fds, Gg^Fds, Gg^Fds
