Gg^Qhh, Gg^Qhh, Gg^Qhh, Gg^Qhh, Gg^Qhhf, Gg^Qhh, Gg^Qhh, Gg^Qhh, Gg^Qhh, Gg^Qhh, Gg^Qhh, Gg^Qhh, Hh^Qhhf, Hh^Qhh, Hh, Hh, Hh, Hh, Hh, Gg^Qhh, Hh^Qhh, Hh^Qhh, Gg^Qhh, Gg, Gg^Fds, Gg^Fds, Gg^Fds, Gg, Hh, Hh, Hh, Gg, Hh, Hh^Fds, Hh^Fds, Ds, Wwg, Wwg, Ds, Ds
Gg^Qhhf, Gg, Hh^Fds, Hh^Fds, Hh, Gg, Hh, Gg, Gg, Gg, Gs^Fds, Hh^Fds, Gs, Hh, Hh^Fms, Hh^Fms, Hh^Fdw, Hh^Fms, Hh^Qhh, Hh, Hh^Qhh, Hh^Qhh, Hh^Fds, Hh^Fds, Gg, Gg^Fds, Hh, Hh, Hh, Hh, Hh^Fds, Hh^Fds, Hh^Fds, Hh^Fds, Gg, Ds, Wwg, Wwg, Wwg, Gs
Hh^Qhhf, Hh^Fds, Hh^Fds, Hh^Fds, Hh^Fdw, Hh, Gg^Fdw, Gg^Fds, Gs, Gg^Fds, Hh, Gg^Fdw, Hh^Fdw, Hh^Fds, Hh^Qhhf, Hh^Fdw, Hh^Qhhf, Hh^Qhhf, Gs, Hh^Qhh, Gs, Hh, Gg, Gg, Gg, Hh, Hh, Hh, Hh^Fds, Hh^Fds, Hh^Fdw, Hh^Fds, Hh^Qhh, Hh^Qhh, Ds, Ds, Ds, Wwg, Wwg^Bw/r, Wwg^Bw/r
Hh^Qhhf, Hh^Fds, Gg, Gg, Gg^Fds, Gg^Fdw, Gs^Qhh, Gg, Hh^_mhh, Hh, Hh^Qhh, Hh, Cer^Qhh, Hh^Qhhf, Hh^Edt, Hh^Qhhf, Gd, Gs, Gs, Gs, Gg^Fds, Gg^Fds, Gg, Gg, Hh, Hh, Hh^Qhh, Hh, Hh^Qhh, Hh^Qhhf, Hh^Qhhf, Hh^Qhhf, Gg^Fds, Gg, Ds, Ds, Rb, Re, Wwg, Wwg
Hh^Qhh, Hh, Gg, Gg, Gg, Gg^Qhh, Gg^Qhh, Hh^Qhh, Hh^Qhh, Hh^Qhh, Gd^Vhr, Hh^Qhh, Ker, Cer^Edt, Gd^Edt, Cer^Edt, Gs, Gs^Edt, Hh^Fds, Hh^Fds, Gg^Fds, Gg, Gg^Qhh, Hh^Qhh, Hh^Qhh, Hh^Qhh, Hh, Hh^Qhh, Gg, Gg^Fdw, Gs^Fdw, Gg^Fds, Gs, Gs, Gs, Re, Re, Gs, Wwg, Wwg
Gg^Qhh, Gg, Hh^Qhh, Hh^Qhh, Hh^Qhh, Hh^Qhh, Gs^Efm, Gs, Gd, Gd^Edt, Gd^Edt, Cer^Edt, Cer, Gs, Gd, Gs, Gg^Fdw, Hh^Fdw, Hh, Hh^Fds, Hh, Hh, Gg^Fds, Gg^Fds, Gg, Gg, Gs, Gs, Gs^Fds, Gg^Fdw, Gs^Qhh, Gs^Qhh, Re, Re, Gs, Rb, Gg^Fdw, Gs^Qhh, Gg^Qhh, Wwg
Gg^Qhh, Hh^Qhh, Gg, Gg^Efm, Gg, Gs^Efm, Gs, Gs, Gs, Gs^Edt, Hh, Gd, Gd^Edt, Gd, Gd, Gs, Gs, Hh, Gg, Hh^Fds, Gg^Fdw, Gg^Fdw, Gg, Gg, Gg^Qhh, Gg, Gg, Gg, Gg^Qhh, Gs^Qhh, Gs, Gs, Re, Gs, Gs, Gs^Fms, Gs^Qhhf, Gs^Qhhf, Hh, Ds^Qhh
Gg, Gg, Gg^Fds, Gg^Fds, Gg, Gg, Hh, Hh, Hh^Fdw, Hh, Gd^Fdw, Cer^Edt, Cer, Gd^Edt, Gd, Gs, Gs, Gs, Gg^Efm, Gg, Gg, Gg, Gg^Efm, Gg^Qhh, Wot, Gg^Qhh, Gg^Qhh, Gs^Qhh, Gg, Gs, Rb, Gg, Gs, Gs, Gs, Gs^Qhhf, Hh^Fds, Hh^_mhh, Gg^Fdw, Hh^Fds
Gg^Fds, Gg^Fds, Hh, Hh, Hh, Hh^Fms, Hh^Fms, Hh^Fds, Hh^Fds, Gs^Fdw, Gs, Cer^Edt, Gd^Edt, Gd, Gs^Efm, Gs^Efm, Gg^Efm, Gg^Efm, Gg^Qhh, Gg^Efm, Gg^Efm, Gg^Efm, Gg, Gg^Qhh, Wot, Wot, Wot, Gg^Qhh, Gg, Rb, Rb, Gg, Gg, Gs^Fms, Gg^Qhhf, Gs^Qhhf, Hh, Hh^Fds, Gg, Gs^Qhh
Gg, Hh, Hh, Hh, Hh, Gs^Vl, Hh, Hh^Fdw, Hh^Fds, Hh, Gs^Fdw, Gs^Fdw, Gs, Gg, Gs^Efm, Gg^Efm, Gg^Qhh, Gg^Qhh, Ww, Gg^Qhh, Gg^Qhh, Gg, Gg^Qhh, Gg^Qhh, Wwt, Wwt, Wwt, Gg^Qhh, Gg^Qhh, Re, Gg, Gg, Gg, Gg^Fdw, Gg^Qhhf, Hh, Gg, Gg^Efm, Gg^Efm, Hh^Qhh
Gg, Hh, Gg, Hh, Hh, Hh, Hh^Fds, Hh^Fdw, Gg^Fds, Gs^Fds, Gg^Qhh, Gs, Gg, Gs, Gg^Qhh, Gg^Qhh, Ww, Ww, Ww, Ww, Ww, Gg^Qhh, Ww, Ww, Ww, Wwt, Wwt, Wwt, Gg^Qhh, Rb, Gg, Gg^Fdw, Gg^Fds, Gg, Gg^Efm, Gg^Qhh, Gg^Qhh, Gg^Efm, Gg^Fds, Gg
Gg, Gg, Hh^Fds, Hh^Fds, Hh^Fdw, Hh^Fdw, Gg, Gg, Gg^Qhh, Gg^Qhh, Wwg, Gg^Qhh, Gg^Qhh, Gg^_mh, Gg^Qhh, Ww, Ww, Ww, Gg^Ve, Ww, Ww, Ww, Ww, Ww, Ww, Wwt, Wwt, Wwt, Gg^Qhh, Re, Gg, Gg^Fdw, Gs^Vl, Gg, Gg^Efm, Gg^Efm, Gg^Qhh, Gg, Gg^Fds, Hh^Qhh
Hh^Fds, Hh^Fds, Hh^Fds, Hh^Fds, Gg, Gg^Fds, Gg^Qhh, Gg^Qhh, Ds, Ds, Wwg, Wo, Wo, Gg^Qhh, Ww, Ww, Ww, Wwt, Gs, Wwt, Ww, Ww, Wwt, Wwt, Wwt, Wwt, Wwt, Gs, Re, Gs, Gg^Fds, Gg^Fds, Gg, Gg, Gg, Gg^Qhhf, Gg^Fds, Gg^Fds, Gg^Fds, Gg^Qhh
Gg, Hh, Hh, Hh, Hh, Gg, Gg^Qhh, Ds, Ds, Ww, Wo, Wo, Wo, Wo, Ww, Ww, Wwt, Gs^Dr, Wwt, Wwt, Wwt, Wwt, Gs^Fdw, Gd^Dr, Wwt, Wwt, Gg, Gs, Gd, Gs, Gg, Gg, Gg, Gg, Gg^Fdw, Gg^Qhhf, Gg^Qhhf, Hh^Fds, Hh, Hh^Qhh
Hh^Fds, Hh^Fds, Hh^Fds, Hh^Fds, Gg^Fdw, Gg^Qhh, Ds, Ds, Wwt, Ww, Ww, Ww, Ww, Ww, Wwt, Ww, Cvr, Wwt, Gs, Wwt, Wwt, Wwt, Wwt, Wwt, Gd, Gg, Gg^Ve, Gg, Wwt^Qhu, Gs, Wwt^Qhu, Gg, Gg, Gg, Gs, Gg^Fds, Hh^Qhh, Hh^Fds, Gg^Efm, Hh^Qhh
Gg^Fds, Hh^Fds, Gg, Gg^Fdw, Gg^Qhh, Gg^Qhh, Ds, Wwt, Ww, Ww, Ww, Ww, Ds, Ds, Wwt, Cvr^Dr, Kvr, Cvr, Gd^Fdw, Gd^Fdw, Gs, Cvr, Cvr^Dr, Gs, Gd^Fdw, Gd^Fdw, Wo^Qhu, Wo^Qhu, Ww, Wwt^Qhu, Wwt, Wwt^Qhu, Gg, Gs, Gs, Hh^Fds, Hh, Gg^Qhh, Gg^Qhh, Gg^Qhh
Gg, Gg, Gg^Fdw, Gg^Fds, Gg, Gg, Gg, Wwt, Wwt, Ww, Wwt, Ww, Wwt, Wwt, Gd, Gs, Gd, Gs, Gd^Fdw, Gd^Fdw, Gd, Gg^Ve, Gd, Gd, Gd, Gd, Wwt^Qhu, Ww, Ww, Ww, Ww, Wwt^Qhu, Wwt^Qhu, Gg, Gg, Gs, Gd, Gg^Efm, Cer^Edt, Gg^Qhh
Gg, Gg^Fds, Gg, Gg, Gg^Efm, Gg, Gg, Wwt, Wwt, Wwt, Gs^Fet, Wwt, Wwt, Cvr, Gd^Efm, Gg^Ve, Gd^Efm, Gd, Gs, Gs, Gs^Fdw, Gd^Fdw, Gs^Fdw, Gs, Wwt^Qhu, Wwt^Qhu, Wwt, Wwt, Wwt, Ww, Ww, Wwt, Wwt, Ds^Qhu, Gs, Gd^Fdw, Gd, Cer^Edt, Ker, Cer^Edt
Gg^Efm, Gg, Gg^Efm, Gg^Efm, Gg^Efm, Gg^Efm, Gg, Wwt, Wwt, Wwt, Wwt, Wwt, Ds, Gs, Gd^Efm, Gd^Dr, Gd^Efm, Gs, Kvr, Gd^Dr, Gd, Gd^Fdw, Gs, Gd, Wwt^Qhu, Wwt, Gs^Fet, Gs, Ww, Ww, Ww, Wwt, Wwt^Qhu, Ds^Qhu, Gs^Fdw, Gd^Fdw, Hh, Hh, Hh, Hh
Gg, Gg^Efm, Gg, Gg, Gs^Vhr, Gg, Gg, Gg, Gg^Fds, Wwt, Gs, Ds, Gd^Fdw, Gd^Efm, Gs, Gd^Efm, Gs, Gs, Cvr^Dr, Cvr, Wo^Qhu, Wo^Qhu, Ww^Qhu, Ww^Qhu, Wwt, Ww^_ml, Ww, Ww, Ds, Ww, Wwt, Wwt, Ds^Qhu, Gs^Fdw, Hh^Fdw, Hh, Hh^Fds, Hh, Gg^Fds, Gg^Fds
Hh^Fds, Gg, Hh^Fdw, Gg^Fms, Hh^Fdw, Gg, Hh, Gg^Fdw, Gg^Fds, Gs, Gg^Fdw, Gg^Ve, Wo^Qhu, Wo^Qhu, Wo^Qhu, Gs, Gs, Cvr, Gg^Ve, Ds^Qhu, Ww, Wo^Qhu, Wwt, Ww, Ww, Ww, Ds^Qhu, Ds^Qhu, Ds^Qhu, Ww, Wwt^Edt, Wwt, Ds^Qhu, Hh^Fds, Hh^Fds, Hh^Fds, Gg^Fds, Gg^Fds, Gg^Fds, Gg
Hh, Hh^Fds, Hh^Fdw, Hh^Fdw, Hh, Hh, Gs, Gs, Gg, Gg, Wo^Qhu, Wo^Qhu, Ww, Wo^Qhu, Ww, Wo^Qhu, Ww^Qhu, Ww^Qhu, Ww^Qhu, Ww^Qhu, Ww, Ww, Gd^Fdw, Gs^Ve, Ww, Ww, Ds^Qhu, Gg, Gg, Ds^Qhu, Ds^Qhu, Ds^Qhu, Hh, Hh, Hh, Gs, Gg, Hh^Fds, Gs^Qhh, Gg^Qhh
Gg, Gg^Fds, Gg, Hh, Hh, Gs, Gd, Gs^Edt, Gs, Wo^Qhu, Wo, Ww, Ww, Ww, Ww, Gd^Dr, Ww, Ww^Qhu, Ww, Ww, Ww, Ww, Ww, Gs^Fet, Ww, Ds^Qhu, Ds, Gg, Gg, Ds^Edt, Gg, Ds, Gg, Hh^Edt, Gg, Gg, Gg^Efm, Gs, Hh^Qhh, Hh^Qhh
Hh, Hh, Hh, Hh^Edt, Gg^Fdw, Gd, Gd^Edt, Gs^Edt, Gs, Wo^Qhu, Wo^Qhu, Wwg, Wwg, Ww, Ww, Ww, Ww, Ww, Gs^Fds, Gs^Fdw, Ww, Ww, Gs, Ww, Gs, Gs, Gd^Fdw, Gg, Gg^Fds, Gg^Fds, Gs, Gs^Edt, Gg^Qhhf, Gg, Gg^Efm, Gg^Efm, Gg^Qhh, Hh^Qhh, Hh, Hh^Qhh
Gg^Fds, Gg^Fdw, Hh, Gs^Edt, Cer^Edt, Gd^Edt, Gd^Edt, Gs, Gd, Gs^Edt, Gs^Edt, Wo^Qhu, Wo^Qhu, Wwg, Ww, Ww, Ww, Ww, Ww, Ww, Ww, Gs, Gd^Edt, Gs, Gd, Gd^Fdw, Gd, Gs, Hh^Qhh, Hh^Qhh, Hh^Qhhf, Hh^Qhhf, Gg, Gg^Qhh, Gg^Qhh, Gg^Efm, Hh^Qhh, Hh, Hh^Fds, Hh^Qhhf
Hh, Hh, Gs^Fdw, Gs^Fdw, Gd^Fdw, Gd^Edt, Cer^Edt, Gd, Gd^Edt, Gd^Edt, Gg, Gs, Wo^Qhu, Wwg, Wwg, Ww, Ww, Ww, Ww, Ww, Gs, Gs, Gd^Edt, Cer^Edt, Gd, Cer^Edt, Cer^Edt, Hh^Qhh, Hh^Edt, Hh, Hh^Fds, Gs, Gg^Efm, Gg, Hh, Hh^Qhh, Hh^Fds, Hh^Fds, Gg^Fds, Gg^Qhhf
Ds, Gg^Fds, Ds, Gd^Fdw, Gd^Edt, Ker, Cer^Edt, Gd, Hh, Gs^Edt, Hh, Gs, Gs, Wwg, Wwg, Wwg, Wwg, Ww, Wwg, Gg, Gs, Gd, Gg^Fdw, Gd, Cer^Edt, Ker, Hh^Qhhf, Hh^Qhhf, Hh, Hh, Gg, Gs^Efm, Gs, Hh, Hh^Fdw, Hh^Fds, Gg, Gg^Efm, Gg, Gg^Qhh
Ds, Ds, Ds, Gs^Fdw, Hh, Hh^Edt, Hh^Fdw, Hh, Hh, Hh^Edt, Hh, Gg, Gg^Efm, Gg, Gg, Wwg, Gg, Wwg, Gg, Gs, Gg, Hh^Fdw, Hh^Qhhf, Gd^Edt, Hh^Qhh, Hh^Qhh, Gg^Vl, Hh, Hh^Fdw, Gg^Fds, Gg^Fds, Gg^Efm, Gs^Edt, Hh, Gg^Fds, Hh^Fdw, Gg, Gg, Hh, Gg^Qhh
Ds, Ds, Ds, Gs, Gg^Fds, Hh^Fdw, Gg^Fds, Gg^Fdw, Gg^Fdw, Gg^Fds, Gg^Efm, Gg^Efm, Gg^Efm, Gg^Efm, Gg, Gg, Gg, Gg, Gg, Gg, Hh^Qhh, Hh^Qhhf, Hh^Qhh, Gg^Qhhf, Hh^Fds, Hh, Hh, Hh, Gg^Fdw, Gg^Fdw, Hh^Fds, Gg, Gg, Gg, Gg, Gg, Gg^_mh, Gs, Hh^Fds, Hh^Qhhf
Ds, Ds, Ds, Ds, Ds, Gg, Gg, Gg, Gg, Gg, Gg, Gg^Efm, Gg^Fds, Gg, Hh, Gg^Fdw, Hh, Hh^Fds, Gg, Gg, Gg^Qhh, Hh^Qhh, Hh^Qhhf, Hh^Qhhf, Hh^Qhh, Hh^Qhh, Hh^Qhh, Gg^Qhhf, Hh^Qhhf, Hh^Qhhf, Hh^Qhhf, Hh^Qhh, Gg^Qhh, Gg^Qhhf, Gg^Qhhf, Gg^Qhhf, Gg^Qhhf, Hh^Qhhf, Hh^Qhhf, Hh^Qhhf
