Gs, Gs, Gll^Fp, Gll^Fms, Re, Gll^Fp, Gll, Gll^Fdf, Gs^Fmf, Hh, Gll^Fdf, Gll^Fdf, Gll^Emf, Hh, Wwg, Wwg^Edb, Ss, Sm, Sm^Edb, Ss^Edb, Ss, Ss, Ss^Em, Gs, Gll^Fdw, Gll, Re^Edb, Ss, Sm^Emf, Gll^Fdw, Gll^Fmw, Hhd^Edb, Hhd^Edb, Gll^Vl, Gll^Fms, Gs^Fms, Gll^Fmw, Ww, Gll^Fp, Gll^Fds, Gs^Fms, Gg, Ww, Ww
Gll^Fp, Gll^Efm, Re^Es, Re, Re^Vct, Gs^Efm, Gd^Em, Gs^Fmf, Hh, Gll^Fmf, Hh^Fmf, Gll^Fdf, Gll^Fmf, Gll^Fmf, Wwg, Wwg^Edb, Hhd^Fmw, Sm, Ss^Emf, Rb^Em, Gll^Fmw, Ss^Em, Ss^Em, Gll^Fmw, Gll^Em, Gll^Fdw, Rb^Em, Ss^Em, Gll^Fmw, Rb^Em, Hhd^Fmw, Ss, Ss, Gll^Fdw, Hh^Fmw, Hh^Fp, Gll^Fmf, Gll^Fp, Gll^Fmf, Gll^Fmf, Gll^Fp, Ww, Gll^Fmf, Ww^Ewl
Gll^Fdf, Gll^Fmf, Re, Gd, 1 Ke, Gll^Fp, Gll^Fmf, Gll^Em, Gll^Fdf, Gll^Fmf, Gll^Fdf, Gll^Fdf, Hh^Fmf, Gll^Em, Wwg, Hh, Hhd^Es, Gll^Fdw, Sm^Em, Gll^Fmw, Gll^Fdw, Ss^Emf, Rb^Fmw, Ss^Tf, Rb^Fmw, Rb^Em, Gll^Fdw, Rb^Fmw, Wwg, Gll^Fdw, Ss^Emf, Hhd^Edb, Hhd^Fmw, Gll^Fmw, Gll^Fp, Hh^Em, Hh^Fp, Hh^Fmf, Ww^Ewl, Gll^Efm, Ww, Ww^Ewl, Gll^Fmf, Hh
Gll^Fp, Gll^Fmf, Re, Gs^Em, Ce, Ce, Gll^Fmf, Gll^Fmf, Gll^Fdf, Gll^Emf, Gll^Fmf, Gll^Fdf, Gll^Vl, Ww, Ww, Ww^Ewl, Hh^Es, Hhd^Fmw, Hhd, Sm^Em, Sm^Edb, Rb^Em, Gll^Fdw, Sm^Emf, Sm^Em, Ss^Edb, Rb^Em, Wwg^Edb, Sm^Em, Rb^Em, Ss^Em, Gll^Fdw, Hhd^Edb, Hh^Fdw, Hh^Em, Gll^Fmf, Hh^Fmf, Ww^Ewl, Hh^Fmw, Ww, Ww, Hh^Es, Hh^Em, Hh^Em
Ww^Ewl, Gll^Efm, Gs^Em, Re^Es, Re^Es, Ce, Gs^Fp, Gll^Fmf, Gll^Emf, Hh^Fmf, Gll^Fmf, Gs^Fmf, Ww, Ww, Rd^Es, Ww^Ewf, Hh^Fmw, Re^Fmw, Gll^Fdw, Ss^Em, Wwg^Edb, Ss^Em, Ss, Sm^Em, Ss^Em, Ss^Tf, Sm, Wwg^Edb, Sm^Edb, Hhd^Fdw, Hhd^Edb, Sm^Em, Mm, Hhd^Fmw, Hh^Fdw, Gll^Fmw, Gd^Efm, Ww, Hh^Fp, Hh^Em, Ww^Ewl, Ww^Ewl, Hh^Fp, Hh^Fmf
Ww, Ww^Ewl, Gd^Em, Re^Vct, Gll^Fdw, Re, Gd^Efm, Gll^Em, Gd^Fmw, Hh^Fp, Gs^Fmw, Hh, Wwf, Ww^Ewl, Rd, Hh^Vhh, Rd^Es, Re^Fdw, Ss^Emf, Ss^Tf, Ss^Em, Wwg^Edb, Ss, Sm^Edb, Rb^Fdw, Sm, Rb^Em, Ss, Hhd^Fmw, Hhd^Edb, Mm, Hhd^Fmw, Mm, Mm, Mm, Hh, Ww, Ww, Hh^Fmf, Hh^Fmf, Hh^Fmf, Hh^Es, Hh^Fp, Hh^Fds
Ds, Ww^Ewl, Ww^Ewl, Gll^Fp, Ww^Ewl, Re^Es, Re, Gs^Fdw, Gd^Efm, Gll^Fmw, Hh, Gll^Fdw, Wwf, Ds^Esd, Ds^Esd, Hh^Fds, Ww^Ewl, Re^Fmw, Re^Es, Gll^Fdw, Sm^Em, Wwg, Wwg^Edb, Sm, Sm, Gll^Fmw, Rb^Es, Gll^Fdw, Mm, Mm, Mm, Mm, Wo, Mm, Ww, Ww^Ewl, Gd^Fp, Ww^Ewl, Mm, Mm, Mm, Mm, Mm, Mm
Ww, Ww, Ww, Ww, Ww, Ww, Ww^Bw|, Ww^Ewl, Ww, Ww^Efm, Ww, Ww, Ds^Esd, Wwf, Ww, Ww, Ww, Ds^Esd, Ds^Esd, Re^Fmw, Sm^Edb, Sm, Ww^Edb, Ww, Ww, Ww, Ww, Wwf, Wo, Wo, Wo, Mm, Wo, Mm, Ww, Ww^Ewl, Hh^Fp, Mm, Mm, Mm, Mm, Mm, Wo, Mm
Wo, Wo, Wo, Wo, Wo, Ww, Ce, Ww, Wo, Ww, Wo, Ww, Ww, Ww, Ww, Wo, Ww, Wwr, Ds, Re^Es, Ww, Ww^Edb, Wo^Edb, Ww, Wo^Edb, Ww^Edb, Ww, Ww, Wwr, Wo, Wo, Mm, Wo, Ww, Ww, Hh^Fmw, Hh^Fmw, Hh^Em, Ww, Ww^Ewl, Wo, Mm, Wo, Wo
Ww, Wo, Wo, Wo, Wo, Wo, Re^Es, Wo, Wo, Wo, Wo, Wo, Wo, Wo, Wo, Wo, Ww, Ww, Wwr, Wwr, Ww, Wo, Wo, Wo^Edb, Wo^Edb, Wo, Wo, Wo, Wo, Wo, Wo, Wo, Wo, Wo, Ww, Ww, Ww, Ww, Wo, Ww, Wo, Wo, Wo, Wo
Ds, Wo, Wo, Wo, Ww, Wo, Ww, Re^Es, Ce, Wo, Wo, Wo, Wo, Wo, Ww^Edb, Wo, Wo, Ww, Wo, Wo, Ww, Ww^Ewl, Ww^Ewl, Wo^Edb, Wo, Wo, Wwr, Wo, Wo, Wo, Wo, Wo, Wo, Wo, Ww, Ww, Ww^Ewf, Ww, Ww^Ewl, Wo, Ww, Wo, Wo, Wo
Ds^Edpp, Ds^Esd, Wo, Wo, Ww, Ww, Ww, Ww, Ww^Bw|, Ww^Edb, Ww, Wo, Wo, Wo, Wo, Wwr, Ww^Ewl, Wo, Ww^Bw\, Ww^Bw\, Rp, Ww, Ww, Wo, Ww, Ww, Ww, Wwr, Wo, Wo, Wo, Wwr, Wwr, Wwr, Gll^Fmf, Ww^Ewf, Mm, Hh, Hh, Ww^Ewl, Mm, Ww, Wo, Wo
Wwf, Ww, Wo, Ww, Ds^Esd, Ww, Ds, Ds, Rd^Edp, Ds^Esd, Rd^Edp, Ww, Wo, Wo, Wwr, Ww, Gd^Fp, Ww^Ewl, Gll^Fmw, Rp^Es, Gs^Efm, Gs^Efm, Ww^Ewf, Ww^Ewl, Ww, Gd^Vc, Hh, Ww, Ww, Wo, Ww, Wwr, Wwr, Gd^Fp, Hh^Fdf, Hh^Em, Mm, Hh^Fmw, Mm, Mm, Mm, Wo, Mm, Wo
Ds, Wo, Ww^Edb, Ww, Hhd^Edpp, Ds, Hhd^Edb, Hhd^Fdw, Re, Gd^Es, Gd^Es, Ww, Ww, Wo, Ww^Ewl, Ww^Ewl, Gd^Fp, Gd^Fmw, Gll^Em, Rp, Rp, Rp, Gll^Em, Ww^Ewf, Gll^Fp, Gd^Vh, Hh^Fp, Hh^Fp, Hh^Fp, Gll^Fp, Gll^Fp, Gs, Gll^Fdf, Gll^Fmf, Gll^Fdf, Hh^Fmf, Hh^Em, Hh^Fp, Hh^Fp, Hh^Fmw, Mm, Mm, Mm, Mm
Ds, Ww^Edb, Rd^Edb, Ds^Esd, Gd^Fdw, Hhd^Fdw, Gll^Fmf, Hhd, Re, Gll^Fdw, Hhd^Fmw, Hhd^Fdw, Ww, Wo, Ww^Ewl, Gll^Fmw, Rp, Rp^Es, Rp, Rp, Gs^Fp, Rp^Es, Rp, Gll^Fp, Hh, Hh, 2 Ke, Hh^Fmf, Hh, Gll^Fp, Gll^Fmf, Gll^Fp, Gs^Fmf, Gll^Fdf, Gll^Fdf, Hh^Fdf, Gll^Fdf, Gll^Fdf, Gll^Fp, Mm, Hh^Fmw, Mm, Mm, Mm
Hhd^Fdw, Ds^Edp, Rd^Edpp, Rd^Es, Rd^Edb, Gd^Fmw, Gd^Fmw, Gll^Fmw, Re^Es, Gll^Fmw, Gll^Fmw, Hhd^Fp, Ww, Ww, Ww^Bw/, Rp, Gll^Fp, Gs^Em, Gll^Emf, Gll^Fp, Gd^Vc, Gs^Em, Gs^Efm, Rp, Rp^Es, Ce, Ce, Ce, Gs^Vl, Gs^Fdw, Gs^Fp, Gs^Fmf, Gd^Fp, Gll^Fmf, Gll^Fp, Gll^Fmf, Gll^Emf, Gll^Fmf, Hh^Em, Hh^Fdf, Hh^Em, Hh^Fmw, Hh^Em, Hh^Fmw
Ww, Hhd^Edpp, Wwf, Wwf^Edb, Wwf, Wwf, Gd^Fdw, Re, Gd^Fmw, Re^Es, Gll^Fmw, Gll^Fmf, Ww^Bw/, Ww^Bw/, Ww, Ce, Gll^Fmw, Gll^Em, Gll^Fmw, Gll^Fp, Gll^Fp, Gd^Vl, Gd^Efm, Gs^Em, Gd^Fp, Rp^Es, Gs^Fmw, Rp, Gll^Fmw, Rp, Gs^Fmw, Gs^Fp, Gll^Fp, Gd^Fmw, Gd^Fmw, Gll^Fp, Gd^Fmf, Gll^Fmf, Gll^Fmf, Gll^Fp, Gll^Fmf, Hh^Fp, Gd^Fp, Hh
Rd, Wwf^Edb, Ds^Esd, Wwf, Ww, Ww^Ewl, Gd^Fdw, Gd^Em, Rb, Gll^Fdw, Re^Em, Gll^Efm, Ww, Ww^Ewl, Ww, Ww, Ww^Ewl, Gll^Fmw, Gll^Em, Gll^Fmw, Gll^Fp, Ww^Ewf, Ww^Ewl, Ww^Ewf, Ww^Ewf, Rp, Gd^Fp, Gll^Fmf, Gll^Fmw, Rp, Rp, Gll^Fmw, Gll^Fmw, Gll^Fdw, Gll^Fp, Gd^Fp, Gll^Fmw, Gd^Fmf, Gll^Fdf, Gll^Fdf, Gs^Em, Gll^Fmf, Gll^Fdf, Gd^Fp
Hhd, Hhd^Es, Hhd^Edp, Ds^Edp, Wwf^Edb, Ww, Gd^Fmw, Gd^Fmw, Gll^Fmf, Rb^Es, Re^Es, Cer, Ker, Ww^Ewl, Ww, Wwr, Wwr, Ww, Ww, Ww^Efm, Ww, Ww^Ewl, Ww, Ww, Ww, Rp, Rp, Gd^Efm, Rp, Rp, Rp, Gd, Rp^Es, Gd^Fdw, Gll^Emf, Gs^Em, Gll^Em, Gll^Fmf, Gll^Fmf, Gll^Fp, Gll^Fp, Gll^Emf, Gll^Fmf, Gd^Fp
Hhd^Fdw, Mm, Hhd^Edb, Rd^Es, Re, Ww, Ww, Gll^Fp, Gll^Fmf, Gll^Fp, Gll^Fmf, Gll^Fmw, Gll^Fp, Gs^Fdw, Gd^Fmw, Wwrg, Wwg, Ww, Ww, Ww, Ww, Ww, Ww, Ww, Ww, Ww, Ww, Rp, Ww, Ww^Efm, Rp, Rp^Es, Gd^Fmw, Rp^Es, Gd^Fp, Gll^Fp, Gll^Fmw, Gll^Fp, Gll^Em, Gll^Fmw, Gll^Fmw, Gll^Fp, Gll^Fmw, Gll^Fp
Hh^Fdw, Gs^Fmw, Hhd^Es, Gd^Fdw, Gd^Fmw, Gd^Fdw, Ww, Hh^Em, Gs^Fmw, Hh^Fmw, Gll^Fmf, Gll^Fmf, Gd^Fp, Re^Em, Re, Gd^Fmw, Gll^Fmf, Wwg, Gll^Fmw, Gll^Fp, Wwg^Edb, Ww, Ww, Ww, Ww, Ww, Ww^Ewl, Ww, Wwf^Bw/, Rp^Es, Ce, Gd^Fdw, Gll^Fmw, Rp^Es, Gd^Fdw, Gll^Fmw, Rp^Es, Gll^Fp, Gll^Fmw, Gll^Fp, Gll^Fmw, Gll^Em, Wwf, Gll^Fp
Mm, Hh^Em, Gs^Fmw, Hhd^Edb, Gd^Fp, Gd^Fmw, Ww, Ww^Ewl, Hh^Fmw, Mm, Hhd^Fmw, Hhd^Fmf, Gll^Fmw, Gll^Emf, Gll^Fmf, Gll^Fdf, Gll^Fmf, Re, Gll^Fp, Gll^Fmf, Gll^Fmw, Wwg, Wwg^Edb, Ww, Wwg^Edb, Wwg, Re^Es, Re^Es, Ww, Wwf, Ww^Ewl, Ww^Ewl, Gll^Fdw, Rp, Rp, Rp, Rp^Es, Gll^Fdw, Wwg, Gll^Fdw, Wwrg, Wwg, Gll^Fp, Wwf
Mm, Mm, Mm, Gll^Fmf, Hh^Fmw, Ww^Ewl, Ww, Gd^Fmw, Hhd^Fmw, Md, Md, Gll^Fp, Hhd^Fdw, Hhd^Fdw, Gll^Fmw, Gll^Fdw, Gll^Fmf, Re^Es, Gll^Em, Gll^Emf, Gll^Fdw, Gll^Em, Wwg, Ce, Re^Es, Wwg^Bw/, Wwg^Edb, Wwg, Wwrg, Ww, Wwr, Gll^Fdw, Ww^Ewl, Gll^Fmw, Wwg, Ww^Ewl, Wwg^Bw|, Wwg, Wwg, Wwg, Wo, Wo, Gll^Fp, Gll^Fp
Mm, Mm, Mm, Hh^Es, Mm, Hh^Es, Ww, Gd^Fmw, Hhd^Fmf, Gll^Fp, Hhd^Fmw, Hhd, Gll^Fdw, Ss^Vhs, Sm^Em, Gll^Em, Gll^Fmw, Gll^Fmw, Rb, Gll^Fmw, Ss^Em, Wwg^Edb, Gll^Emf, Gll^Fdw, Gll^Fmw, Wwg^Edb, Wwg^Edb, Wwrg, Wwg^Edb, Ww, Wwrg, Wwr, Wwrg, Ww, Wwg, Wwrg, Wwg^Bw|, Wwg^Edb, Wwg^Edb, Wwrg, Wwrg, Wo, Wo, Wo
Mm, Wo^Ewl, Wo^Ewl, Wo, Mm, Hh^Fdw, Ww, Hhd^Fmf, Hhd^Fp, Hhd^Fp, Hhd^Fmw, Hhd^Fdw, Ss^Tf, Rb^Es, Rb^Es, Gll^Fdw, Wwg^Edb, Gll^Fmw, Sm, Sm^Bw\r, Ss^Bw|r, Ss^Tf, Gll^Fdw, Rb^Em, Rb^Em, Gll^Fdw, Gll^Fmw, Gll^Fmw, Sm^Edb, Wwg^Edb, Wwg^Edb, Wwrg, Wwg^Edb, Wwg, Gd^Fp, Wwg^Edb, Re, Wwg^Edb, Wwg, Wwg, Wwg, Wo, Wo, Wo
Wo, Wo^Ewl, Wo, Wo, Ww, Wwr, Wwr, Ww, Wwg, Wwrg, Wwg^Edb, Gll^Fdw, Rb^Es, Chr, Ss^Edb, Ss^Edb, Wwg^Edb, Ss^Emf, Ss^Edb, Sm^Em, Rb^Em, Ss^Emf, Rb^Em, Gll^Fmw, Gll^Fmw, Gll^Fmf, Rb, Gll^Fmw, Sm^Bw/r, Wwrg, Wwg^Edb, Rb^Fdw, Cer, Ker, Gd^Fp, Gd^Fp, Gd^Fp, Chr, Gd^Fp, Gll^Fdw, Gd^Fmw, Wwg^Edb, Wwg, Wwg
Wwr, Wo, Wo, Wo, Wwr, Wwr, Ww^Vm, Wo, Wwrg, Wwrg, Wwg^Edb, Khr, Chr, Chr, Rb^Em, Rb^Fdw, Sm^Vhs, Rb^Fmw, Gll^Fmw, Hhd^Fmw, Gll^Fdw, Rb^Em, Gll^Fmw, Hhd^Fmw, Sm^Em, Rb^Em, Sm^Edb, Sm^Bw\r, Ss^Emf, Ss^Bw\r, Ss^Bw\r, Ss, Gll^Fp, Sm^Em, Rb^Em, Re, Aa^Fpa, Gll^Fdw, Gd^Fp, Re^Fp, Aa^Fp, Wwg^Edb, Wwg^Edb, Wwg
Wwr, Wo, Wo, Wwr, Wwr, Ww^Ewl, Wwr, Wo, Wwg, Wwg, Ss^Em, Chr, Chr, 3 Khr, Rb^Fmw, Sm^Em, Rb^Fmw, Ss^Tf, Gll^Fdw, Rb, Hhd^Fmw, Rb, Ss^Bw\r, Hhd^Fdw, Rb, Ss^Em, Rb^Fdw, Sm^Em, Wwg, Rb^Fdw, Sm^Em, Re^Fmw, Aa^Fdw, Sm^Emf, Gll^Fmw, Gd^Fmw, Aa^Fma, Aa^Fma, Re^Fmw, Ha^Es, Aa^Fda, Re^Fmw, Wwg^Edb, Wwg
Wwr, Wwr, Ww, Ww, Ww, Ww, Ww, Ww, Wwrg, Wwg^Edb, Ss^Em, Ss^Tf, Rb, Chr, Rb^Es, Rb^Fdw, Gll^Fp, Ss^Emf, Gll^Fmw, Re^Es, Hhd^Fdw, Hhd^Fmw, Sm^Em, Sm^Bw/r, Gll^Fp, Gll^Fp, Gll^Fmf, Ss^Emf, Ss, Rb^Fmw, Ss^Tf, Re^Fp, Aa^Fpa, Aa^Fdw, Gll^Fmw, Rb, Xu, Aa^Fdw, Ha^Fdw, Aa^Fda, Aa^Fdw, Aa^Fdw, Wwg, Wwrg
Ww, Ww^Ewl, Ww^Ewl, Ww, Ww^Ewl, Ww, Hh^Fdw, Wwg, Hhd^Fdw, Wwrg, Wwg, Gll^Fdw, Gll^Fdw, Ss^Emf, Gll^Fp, Gll^Fdw, Rb^Es, Rb, Gll^Fmw, Gll^Fdw, Gll^Fp, Gll^Fmw, Gll^Fmw, Hhd^Fdw, Hhd^Es, Gll^Fmf, Sm^Em, Gll^Fmf, Gll^Fp, Ss^Emf, Aa^Em, Aa^Fmw, Aa^Fda, Aa^Fdw, Rb, Gll^Fp, Xu, Xu, Xu, Ha^Fma, Xu, Xu, Wwrg, Wwrg
Hh^Es, Ww^Ewl, Hh^Es, Ww, Ww^Ewl, Hh^Fmw, Md, Md, Hhd^Fmw, Hhd^Es, Rb^Es, Ss^Em, Ss^Bw/, Rb^Em, Gll^Fmw, Gll^Fp, Gll^Vhr, Gll^Fdw, Sm^Em, Gll^Fmw, Hhd^Fmw, Hhd^Fmw, Hhd^Fp, Hhd^Es, Gll^Fp, Gll^Fmw, Wwg^Edb, Gll^Fp, Gll^Fmw, Ker, Cer, Ha, Aa^Fdw, Aa^Fda, Urb, Uu, Uu, Xu, Xu, Xu, Xu, Wwg, Wwrg, Wwrg
Hh^Em, Hh^Fdw, Hh^Fmw, Ww, Ww, Hh^Fmw, Md, Hhd^Fmw, Hhd^Vhhr, Re^Es, Hhd^Fdw, Rb^Es, Sm^Em, Sm^Em, Ss^Emf, Gll^Fmw, Re^Fp, Wwg, Wwg^Edb, Ss^Em, Md, Md, Hhd^Fp, Re^Em, Gll^Fdw, Gll^Fdw, Ss^Em, Aa^Fmw, Aa^Fdw, Aa^Fdw, Ha^Fpa, Ha^Fpa, Xu, Aa^Fda, Uu, Urb, Uu, Xu, Xu, Xu, Wwg^Edb, Wwg, Wwg^Edb, Wwg
Gll^Fp, Gll^Fmw, Gll^Fp, Mm, Mm, Wo, Wo, Hhd^Fmw, Md, Md, Md, Hhd^Fdw, Rb^Em, Sm, Wwg^Edb, Hhd^Fmw, Hhd^Fmw, Hhd^Fdw, Mm, Ss^Tf, Md, Md, Ss^Emf, Sm^Em, Wwrg, Wwg^Edb, Sm^Em, Gll^Fp, Hhd^Em, Ha^Fmw, Aa^Fda, Ha^Fpa, Ha^Fpa, Xu, Uh, Uu, Urb, Uu, Uu^Vu, Xu^Exw, Uh, Wwrg, Xu, Xu
Hh^Fdw, Hh^Em, Hh^Fmw, Hh^Fp, Mm, Mm, Wo, Mm, Hh^Fdw, Md, Ss^Tf, Ss^Emf, Sm^Em, Hhd^Fdw, Rb^Fmw, Wwg^Edb, Sm^Em, Ss^Em, Md, Mm, Mm, Md, Hhd^Fdw, Wwrg, Ss^Vhs, Wwg, Ss^Em, Ss^Emf, Ss^Tf, Aa^Fda, Aa^Fma, Ha^Fpa, Xu, Xu, Xu, Uu, Uu, Urb, Urb, Uu, Uh, Wwg^Edb, Wwrg, Xu
Gs^Fdw, Hh^Em, Mm, Mm, Mm, Mm, Mm, Wo^Ewl, Mm, Md, Mm, Hhd^Fdw, Md, Hhd^Fmw, Hhd, Gll^Fdw, Ss^Em, Ss^Emf, Hhd^Fmw, Hhd^Fmw, Mm, Mm, Gll^Fdw, Ss^Emf, Ss^Emf, Wwrg, Ss^Em, Sm^Em, Gd^Fmw, Aa^Fpa, Ha^Fdw, Ms, Ms, Xu, Xu, Uh, Uu, Uu, Urb, Cfr, Cfr, Wwg^Edb, Xu, Xu
Gll^Fmw, Hh^Fmw, Hh^Fp, Mm, Mm, Mm, Mm, Wo, Mm, Mm, Mm, Mm, Mm, Md, Hhd^Fmw, Rb^Em, Hhd, Sm^Tf, Gll^Fdw, Mm, Hhd^Fdw, Hhd^Em, Sm^Em, Sm^Em, Sm^Em, Ss^Em, Wwrg, Sm^Em, Aa^Fmw, Aa^Fdw, Ha^Fdw, Ms, Ms, Xu, Xu, Xu, Uh^Vu, Urb, Cfr, 4 Kfr, Cfr, Uh, Xu, Xu
Hh^Em, Gll^Fmw, Hh^Fp, Mm, Hh^Fdw, Wo, Wo^Ewl, Wo^Ewl, Hh^Fdw, Mm, Mm, Mm, Mm, Mm, Hhd^Fmw, Gll^Fdw, Mm, Hhd^Fmw, Hhd^Fmw, Hhd^Em, Hhd^Fdw, Ss^Tf, Sm^Em, Sm^Vhs, Sm^Em, Wwrg, Ss^Em, Wwrg, Hhd^Fmw, Ha^Fmw, Aa^Fpa, Ms, Xu, Ms, Xu, Xu, Xu, Uh, Uh^Edb, Cfr, Uh, Xu, Xu, Xu
Gs^Fp, Gll^Fp, Gs^Fp, Mm, Wo, Wo, Wo, Wo^Ewl, Mm, Mm, Hh, Gll^Fp, Mm, Hh^Fp, Gg, Gll^Fmw, Gs^Fp, Hhd^Fmw, Gg, Ss, Ss, Ss^Emf, Ss, Ss, Ss, Ss, Ww, Gd^Fmw, Aa^Fpa, Ha^Fma, Ha, Xu, Xu, Xu, Xu, Xu, Xu, Xu, Xu, Uh^Edb, Xu, Uh^Edb, Xu, Xu
