Gs^Qhhf, Gs^Qhh, Gll^Qhhf, Gll^Fms, Re, Gll^Fp, Gll, Gll^Fdf, Gs^Fmf, Mm, Gll^Fmf, Gll^Fdf, Hh^Tf, Hh, Hh, Hh, Wwg^Edb, Sm, Hhd^Fmw, Rb^Em, Hhd, Hhd, Hhd, Wog, Wwg, Wog, Wwg, Hhd^Edb, Hhd^Edb, Wog, Chw, Wog, Wog, Wog, Wwg, Gs^Fms, Wog, Ww, Hh^Fmw, Ww
Gll^Qhhf, Gll^Efm, Gd^Em, Re^Qhh, Gll^Qhhf, Gd^Em, Gd^Em, Gs^Fmf, Hh, Gll^Fmf, Gll^Fdf, Hh^Tf, Gll^Fdf, Gll^Fmf, Wwg, Wwg^Edb, Hhd^Fmw, Hhd^Fmw, Hhd^Fmw, Rb^Vl, Gll^Fmw, Wwg, Wwg^Ewl, Wwg, Wog, Wwg, Hhd^Fdw, Hhd^Edb, Hhd^Edb, 5 Khw, Chw, Wog, Wog, Wog, Wwg, Wwg, Gll^Fmf, Gll^Fp, Hh^Fp, Hh^Em
Gll^Qhhf, Gll^Fmf, Re^Qhhf, Re, Gll^Qhhf, Gll^Fdf, Gll^Fmf, Gll^Qhhf, Gll^Fdf, Gll^Fdf, Gll^Fdf, Gll^Fdf, Gll^Fdf, Gll^Em, Wwg, Hh, Wwg, Gll^Fdw, Hhd^Fmw, Gll^Fmw, Wwg^Ewl, Wwg^Ewl, Wwg, Wwg, Wog, Hhd^Fdw, Hhd, Hhd^Edb, Wwg, Chw, Wog, Wog, Wog, Wwg, Wog, Hh^Em, Hh, Hh, Hh, Ww
Gll^Qhhf, Re, Re^Qhhf, Re, Re^Qhh, Gll^Fmf, Re^Vct, Gll^Qhhf, Gll^Fdf, Tb^Tf, Hh^Tf, Hh^Tf, Gll^Em, Wwg, Wwg, Wwg, Wog, Hh, Wwg, Wwg^Ewl, Wwg, Wwg^Ewl, Wwg, Wog, Hhd, Hhd, Wog, Wog^Edb, Wog^Edb, Wog, Wog, Wwg, Wwg, Wog, Ww, Ww, Wwg^Ewl, Wwg^Ewl, Ww^Ewl, Wo
Gll^Qhhf, Gll^_mh, Gll^Qhhf, Ce, 1 Ke, Re, Gll^Fmf, Gll^Qhhf, Hh^Qhhf, Hh^Tf, Hh^Tf, Gs^Fmf, Wwg, Wwg, Wwg, Wwg, Wog, Wog, Wwg, Wwg, Wwg, Wwg, Wog, Wog, Wog, Wog, Wog, Wog, Wog, Wog, Wog, Sm^Em, Gll^Vl, Wwr, Gll^Fmf, Ww^Ewf, Mm, Hh, Hh, Ww^Ewl
Wwg, Gll^Qhhf, Gll^Fp, Ce^Qhh, Ce^Qhh, Re, Re^Vct, Re^Vct, Hh^Qhhf, Tb^Tf, Hh^Tf, Wwg, Wog, Wog, Wog, Wog, Wog, Wog, Wog, Wog, Wog, Wog, Wog, Wog^Edb, Wog, Wog, Wwg^Ewl, Wwg, Wwg^Ewl, Wwg, Wwg, Gll^Qhh, Wwr, Gll^Fp, Hh^Fdf, Hh^Em, Mm, Hh^Fmw, Mm, Mm
Wwg, Wwg^Ewl, Wwg^Ewl, Ds^Esd, Wwg^Ewl, Re^Qhh, Re^Qhh, Gs^Qhhf, Hh^Tf, Hh^Tf, Wwg, Wog, Wog, Wog, Wog, Wog, Wog, Wog, Wog, Wog, Wog, Wog, Hhd^Qhh, Ww^Ewf, Hhd^Qhh, Wog, Hh^Qhh, Wwg^Ewl, Hh^Qhh, Gll^Qhh, Gll^Qhh, Gs^Qhh, Gll^Fdf, Gll^Fmf, Gll^Fdf, Hh^Fmf, Hh^Em, Hh^Fp, Hh^Fp, Hh^Fmw
Ds, Wwg, Wwg, Wwg, Wwg, Wwf, Wwf, Wwg, Wog, Wog, Wog, Wog, Wog, Wog, Wog, Wog, Wog, Wog, Wog, Wog, Wog, Wog, Hhd^Qhh, Hhd^Qhh, Hh, Hh^Qhh, Gs^Vct, Hh^Qhh, Hh, Gll^Fp, Gll^Fmf, Gll^Fp, Gs^Fmf, Gll^Fdf, Gll^Fdf, Hh^Fdf, Gll^Fdf, Gll^Fdf, Gll^Fp, Mm
Ds^Edpp, Ds^Esd, Wwg, Wog, Wwg, Wwg, Wwg, Wwg, Wog, Wog, Wog, Wog, Wog, Wog, Wog, Wog, Wog, Wog, Wog, Wog, Ds, Ds, Gs^Qhh, Gll, Rp^Es, Rp^Es, Rp^Es, Gs, Gs^Vct, Ce^Qhh, Gs^Fp, Gs^Fmf, Gd^Fp, Gll^Fmf, Wwg^Ewl, Gll^Fmf, Wwg, Gll^Fmf, Wwg, Wwg
Wwf, Wwg, Wwg, Wwg, Ds^Esd, Wwf, Ds, Re, Rd^Tf, Rd^Tf, Wwg, Wog, Wog, Wog, Wog, Wog, Wog, Wog, Wog, Wog, Gs^Qhh, Gs^Qhh, Ce, Gs^Vct, Ce, Gs, Gs^Fmw, Re^Vct, Gll^Fmw, Rp, Gs^Fmw, Gs^Fp, Wwg, Wwg^Ewl, Wwg, Wwg^Ewl, Gd^Qhhf, Wwg, Gll^Qhhf, Wwg^Ewl
Wwg, Wog, Wwg, Wwg, Hhd^Edpp, Ds, Hhd, Re, Tb^Tf, Tb^Tf, Wog, Wog, Wog, Wog, Wog, Wog, Wog, Wog, Wog, Hhd^Qhh, Gd^_mh, Gll^Fmf, Gs^Fp, 2 Ke, Ce, Rp^Qhh, Gd^Fp, Gll^Fmf, Gll^Fmw, Wwg, Wwg, Wwg, Gll^Qhhf, Gll^Qhhf, Gll^Qhhf, Gd^Qhhf, Gll^Fmw, Gd^Qhhf, Gll^Fdf, Gll^Qhhf
Wwg, Wwg, Rd^Edb, Ds^Esd, Gd^Fdw, Hhd^Fdw, Gll^Vl, Re, Wwf, Rd^Tf, Wwg, Wog, Wwg, Wwg, Wog, Wog, Wog, Wog, Ce^Qhh, Hhd^Qhh, Gd^Qhhf, Gs^Fp, Rp^Qhh, Rp^Qhh, Rp^Qhh, Wwg^Qhh, Wwg^Ewl, Wwg^Ewl, Wwg, Wwg, Rp^Qhh, Gd^Qhhf, Rp^Es, Gd^Fdw, Gll^Emf, Gs^Em, Gll^Em, Gll^Fmf, Chr, Xu^Qhh
Hhd^Fdw, Ds^Edp, Rd^Edpp, Rd^Es, Rd^Edb, Gd^Fmw, Gd^Fmw, Gll^Fmw, Wwf, Wwf, Wwf, Wwg, Wwg, Wwg, Wog, Wog, Wog, Wwg, Gd^Qhh, Gd^Qhh, Wwg, Rp^Qhh, Wwg, Ce^Qhh, Wwg, Wwg, Wog^Edb, Wwg, Gll^Qhhf, Ww^Efm, Re^Qhh, Rp^Es, Gd^Fmw, Gll^Vl, Gd^Fp, Gll^Fp, Gll^Fmw, 4 Khr, Chr, Xu^Qhh
Wwg, Hhd^Edpp, Wwf, Wwf^Edb, Wwf, Wwf, Wwf, Wwf, Re, Wwf, Wwf, Re, Wwg, Wwg, Wwg, Wog, Wwg, Wwg, Wwg, Wwg^Edb, Wog^Edb, Wog, Wog, Wwg, Wog^Edb, Wwg, Wwg, Re^Qhh, Re, Gll^Qhh, Rp^Es, Re, Wwg, Rp^Es, Gll^Fmw, Gll^Fmw, Gll^Fdw, Chr, Xu, Xu^Qhh
Wwg, Wwf^Edb, Wwg, Rd^Edb, Gd^Fmw, Wwg, Gll^Fmf, Wwg, Cer, Re, Wwf, Wwf, Wwf, Wwf^Ewl, Re^Qhh, Wwf, Wwf, Wwg, Wwg, Wog^Edb, Wwg^Ewl, Wog, Wwg^Ewl, Wwg, Gll^Qhhf, Rp^Qhh, Gll^Qhh, Rp^Qhh, Gll^Qhh, Rp, Re, Gll^Fmw, Xu, Gll^Fmw, Xu, Gll^Fmw, Chr, Xu, Xu, Xu^Qhh
Wog, Wwg, Wog, Wwg, Wog, Wwg, Gll^Fmf, Gd^Fmw, Wwg, Wwf, Re^Es, Cer, Cer, Wwf^Ewl, Gll^Fmw, Re^Qhh, Re^Qhh, Wwg, Gll^Qhh, Gll^Qhh, Gll^Qhh, Gll^Qhhf, Gll^Qhhf, Gll^Qhhf, Re, Re, Gll^Fmf, Gll^Fmw, Wwg, Rp^Qhh, Rp, Xu, Xu, Xu, Xu, Aa^Fda, Xu, Xu, Xu, Xu^Qhh
Wog, Wog, Wog, Wog, Wwg, Wwg, Wwg, Wwg, Gll^Fmf, Gll^Fp, Cer, 3 Ker, Cer, Gs^Fdw, Gd^Fmw, Gll^Fmw, Re, Gll^Qhh, Gll^Fmf, Gll^Fmf, Rp^Es, Wwg, Rp^Es, Re, Gll^Fmf, Re, Gll, Xu, Xu, Rp^Es, Rp^Es, Xu, Xu, Xu, Xu, Xu, Xu, Xu, Xu, Xu^Qhh
Wwg, Wwg, Wwg, Wwg, Wwg, Wwg, Wwg, Hh^Em, Gs^Fmw, Hh^Fmw, Gd^Fp, Gll^Fmf, Gd^Fp, Re^Em, Gd^Fmw, Re^Vhhr, Gll^Fmf, Re, Re, Re, Re, Re, Rp^Es, Gll^Fp, Gll^Fp, Gll, Aa, Xu, Ha, Gll, Aa^Fdw, Rp, Rp, Chr^_mhh, Gll^Fdw, Xu, Aa, Gll^Fdw, Aa^Fda, Xu^Qhh
Wog, Wwg, Wwg, Wwg, Ds^Esd, Gd^Fmw, Gs^Fmw, Hh^Em, Hh^Fmw, Mm, Md, Gd^Fp, Hhd^Vhhr, Gll^Emf, Gll^Fmf, Gll^Fdf, Gll^Fmf, Re, Gll^Fp, Gll^Fmf, Wwg, Gll^Fp, Gll^Fp, Hh^Fp, Hh^Fp, Hh^Fp, Xu, Ha^Fda, Ms, Ha, Chr, Rp, Aa^Vca, Rp^Es, Rp, Chr, Rp, Aa^Fdw, Gll^Fdw, Xu^Qhh
Ds^Esd, Ds^Esd, Ds^Esd, Ds^Esd, Hh^Fmw, Gs^Fmw, Gd^Fmw, Gd^Fmw, Hhd^Fmw, Md, Md, Gd^Fp, Hhd^Fdw, Hhd^Fdw, Gll^Fmw, Gll^Fdw, Gll^Fmf, Re^Es, Gll^Em, Gll^Emf, Gll^Fp, Gll^Fp, Hh^Fp, Hh^Fp, Mm, Aa^Fda, Ha^Fda, Ms, Ms, Ms, Xu, Aa^Fda, Aa, Rp, 6 Khr, Chr, Chr, Aa^Fda, Aa, Chr
Gll^Fmf, Ds^Esd, Gll^Fmf, Ds^Esd, Mm, Gd^Fmw, Ww, Gd^Fmw, Hhd^Fmf, Gll^Fp, Hhd^Fmw, Hhd, Gll^Fdw, Gll^Fmw, Sm^Em, Gll^Em, Gll^Fmw, Gll^Fmw, Rb, Gll^Fmw, Gll^Fp, Hh^Fp, Gll^Fp, Mm, Gll^Fp, Xu, Xu, Xu, Xu, Xu, Xu, Aa^Fdw, Xu, Cha, Rp, Chr, Chr, Aa, Xu, Xu
