Gs^Qhhf, Gs^Qhh, Gll^Qhhf, Gll^Fms, Re, Gll^Fp, Gll, Gll^Fdf, Gs^Fmf, Mm, Gll^Fmf, Gll^Fdf, Hh^Tf, Hh, Hh, Hh, Wwg^Edb, Sm, Hhd^Fmw, Rb^Em, Hhd, Hhd, Hhd, Wog, Wwg, Wog, Wwg, Hhd^Edb, Hhd^Edb, Wog, Chw, Wog, Wog, Wog, Wwg, Gs^Fms, Wog, Ww, Hh^Fmw, Ww
Gll^Qhhf, Gll^Efm, Re^Es, Re^Qhh, Gll^Qhhf, Gs^Efm, Gd^Em, Gs^Fmf, Hh, Gll^Fmf, Gll^Fdf, Hh^Tf, Gll^Fdf, Gll^Fmf, Wwg, Wwg^Edb, Hhd^Fmw, Hhd^Fmw, Hhd^Fmw, Rb^Em, Gll^Fmw, Wwg, Wwg^Ewl, Wwg, Wog, Wwg, Hhd^Fdw, Hhd^Edb, Hhd^Edb, Khw, Chw, Wog, Wog, Wog, Wwg, Wwg, Gll^Fmf, Gll^Fp, Hh^Fp, Hh^Em
Gll^Qhhf, Gll^Fmf, Re^Qhhf, Re, Gll^Qhhf, Gll^Fdf, Gll^Fmf, Gll^Qhhf, Gll^Fdf, Gll^Fdf, Gll^Fdf, Gll^Fdf, Gll^Fdf, Gll^Em, Wwg, Hh, Wwg, Gll^Fdw, Hhd^Fmw, Gll^Fmw, Wwg^Ewl, Wwg^Ewl, Wwg, Wwg, Wog, Hhd^Fdw, Hhd, Hhd^Edb, Wwg, Chw, Wog, Wog, Wog, Wwg, Wog, Hh^Em, Hh, Hh, Hh, Ww
Gll^Qhhf, Re, Re^Qhhf, Re, Re^Qhh, Gll^Fmf, Gll^Fmf, Gll^Qhhf, Gll^Fdf, Tb^Tf, Hh^Tf, Hh^Tf, Gll^Vl, Wwg, Wwg, Wwg, Wog, Hh, Wwg, Wwg^Ewl, Wwg, Wwg^Ewl, Wwg, Wog, Hhd, Hhd, Wog, Wog^Edb, Wog^Edb, Wog, Wog, Wwg, Wwg, Wog, Ww, Ww, Wwg^Ewl, Wwg^Ewl, Ww^Ewl, Wo
Gll^Qhhf, Gll^_mh, Gll^Qhhf, Ce, Ke, Re, Gs^Fp, Gll^Qhhf, Hh^Tf, Hh^Tf, Hh^Tf, Gs^Fmf, Wwg, Wwg, Wwg, Wwg, Wog, Wog, Wwg, Wwg, Wwg, Wwg, Wog, Wog, Wog, Wog, Wog, Wog, Wog, Wog, Wog, Sm^Em, Gll^Qhh, Wwr, Gll^Fmf, Ww^Ewf, Mm, Hh, Hh, Ww^Ewl
Wwg, Gll^Qhhf, Gll^Fp, Ce^Qhh, Ce^Qhh, Re, Gll^Fdf, Hh^Qhhf, Tb^Tf, Tb^Tf, Hh^Tf, Wwg, Wog, Wog, Wog, Wog, Wog, Wog, Wog, Wog, Wog, Wog, Wog, Wog^Edb, Wog, Wog, Wwg^Ewl, Wwg, Wwg^Ewl, Wwg, Wwg, Gll^Qhh, Wwr, Gll^Fp, Hh^Fdf, Hh^Em, Mm, Hh^Fmw, Mm, Mm
Wwg, Wwg^Ewl, Wwg^Ewl, Ds^Esd, Wwg^Ewl, Re^Qhh, Re^Qhh, Gs^Qhhf, Hh^Tf, Hh^Tf, Wwg, Wog, Wog, Wog, Wog, Wog, Wog, Wog, Wog, Wog, Wog, Wog, Hhd^Qhh, Ww^Ewf, Hhd^Qhh, Wog, Hh^Qhh, Wwg^Ewl, Hh^Qhh, Gll^Qhh, Gll^Qhh, Gs^Qhh, Gll^Fdf, Gll^Fmf, Gll^Fdf, Hh^Fmf, Hh^Em, Hh^Fp, Hh^Fp, Hh^Fmw
Ds, Wwg, Wwg, Wwg, Wwg, Wwf, Wwf, Wwg, Wog, Wog, Wog, Wog, Wog, Wog, Wog, Wog, Wog, Wog, Wog, Wog, Wog, Wog, Hhd^Qhh, Hhd^Qhh, Hh, Hh^Qhh, Rp^Es, Hh^Qhh, Hh, Gll^Fp, Gll^Fmf, Gll^Fp, Gs^Fmf, Gll^Fdf, Gll^Fdf, Hh^Fdf, Gll^Fdf, Gll^Fdf, Gll^Fp, Mm
Ds^Edpp, Ds^Esd, Wwg, Wog, Wwg, Wwg, Wwg, Wwg, Wog, Wog, Wog, Wog, Wog, Wog, Wog, Wog, Wog, Wog, Wog, Wog, Wog, Wog, Gs^Qhh, Gll, Rp^Es, Rp^Es, Rp^Es, Rp^Es, Gs^Vl, Gs^Fdw, Gs^Fp, Gs^Fmf, Gd^Fp, Gll^Fmf, Wwg^Ewl, Gll^Fmf, Wwg, Gll^Fmf, Wwg, Wwg
Wwf, Wwg, Wwg, Wwg, Ds^Esd, Wwf, Ds, Re, Rd^Tf, Rd^Tf, Wwg, Wog, Wog, Wog, Wog, Wog, Wog, Wog, Wog, Wog, Gs^Qhh, Gs^Qhh, Ce, Gs^Em, Ce, Rp^Es, Gs^Fmw, Ce, Gll^Fmw, Rp, Gs^Fmw, Gs^Fp, Wwg, Wwg^Ewl, Wwg, Wwg^Ewl, Gd^Qhhf, Wwg, Gll^Qhhf, Wwg^Ewl
Wwg, Wog, Wwg, Wwg, Hhd^Edpp, Ds, Hhd^Edb, Re, Tb^Tf, Tb^Tf, Wog, Wog, Wog, Wog, Wog, Wog, Wog, Wog, Wog, Hhd^Qhh, Gd^_mh, Gd^Fp, Gd^Fp, Ke, Ce, Rp^Qhh, Gd^Fp, Gll^Fmf, Gll^Fmw, Wwg, Wwg, Wwg, Gll^Qhhf, Gll^Qhhf, Gll^Qhhf, Gd^Qhhf, Gll^Fmw, Gd^Qhhf, Gll^Fdf, Gll^Qhhf
Wwg, Wwg, Rd^Edb, Ds^Esd, Gd^Fdw, Hhd^Fdw, Gll^Fmf, Re, Re, Rd^Tf, Wwg, Wog, Wog, Wog, Wog, Wog, Wog, Wog, Ce^Qhh, Hhd^Qhh, Gd^Qhh, Gd^Fp, Rp^Qhh, Rp^Qhh, Rp^Qhh, Wwg^Qhh, 2 Wwg^Ewl, Wwg^Ewl, Wwg, Wwg, Rp^Qhh, Gd^Qhhf, Rp^Es, Gd^Fdw, Gll^Emf, Gs^Em, Gll^Em, Gll^Fmf, Chr, Xu^Qhh
Hhd^Fdw, Ds^Edp, Rd^Edpp, Rd^Es, Rd^Edb, Gd^Fmw, Gd^Fmw, Gll^Fmw, Re^Es, Gll^Fmw, Gll^Fmw, Wog, Wwg, Wog, Wog, Wog, Wog, Wwg, Gd^Qhh, Gd^Qhh, Wwg, Rp^Qhh, Wwg, Ce^Qhh, Wwg, Wwg, Wog^Edb, Wwg, Gll^Qhhf, Ww^Efm, Re^Qhh, Rp^Es, Gd^Fmw, Rp^Es, Gd^Fp, Gll^Fp, Gll^Fmw, Khr, Chr, Xu^Qhh
Ww, Hhd^Edpp, Wwf, Wwf^Edb, Wwf, Wwf, Wwf, Wwf, Wwf, Re^Es, Wwf, Gll^Fmf, Wwg, Wog, Wwg, Wog, Wog, Wwg, Wwg, Wwg^Edb, Wog^Edb, Wog, Wog, Wwg, Wog^Edb, Wwg, Wwg, Re^Qhh, Re, Gll^Qhh, Rp^Es, Re, Wwg, Rp^Es, Gll^Fmw, Gll^Fmw, Gll^Fdw, Chr, Xu, Xu^Qhh
Rd, Wwf^Edb, Ds^Esd, Rd^Edb, Gd^Fmw, Wwg, Wwf, Wwg, Wwg, Wwg, Wwf, Wwf, Wwg, Wwg^Ewl, Re^Qhh, Wwg, Wwg, Wwg, Wwg, Wog^Edb, Wwg^Ewl, Wog, Wwg^Ewl, Wwg, Gll^Qhhf, Rp^Qhh, Gll^Qhh, Rp^Qhh, Gll^Qhh, Rp, Re, Gll^Fmw, Xu, Gll^Fmw, Xu, Gll^Fmw, Chr, Xu, Xu, Xu^Qhh
Hhd, Hhd^Es, Hhd^Edp, Ds^Edp, Gd^Fmw, Gd^Fmw, Gd^Fmw, Gd^Fmw, Ww, Wwf, Re^Es, Cer, Cer, Wwg^Ewl, Gll^Fmw, Re^Qhh, Re^Qhh, Wwg, Gll^Qhh, Gll^Qhh, Gll^Qhh, Gll^Qhhf, Gll^Qhhf, Gll^Qhhf, Re, Re, Gll^Fmf, Gll^Fmw, Wwg, Gll^Qhh, Rp, Xu, Xu, Xu, Xu, Gll^Fp, Xu, Xu, Xu, Xu^Qhh
Hhd^Fdw, Mm, Rd^Es, Rd^Es, Re, Gd^Fmw, Ww, Wwf, Gll^Fmf, Gll^Fp, Cer, Ker, Cer, Gs^Fdw, Gd^Fmw, Gll^Fmw, Re, Gll^Qhh, Gll^Fmf, Gll^Fmf, Rp^Es, Wwg, Rp^Es, Re, Gll^Fmf, Re, Gll^Fp, Gll^Fp, Xu, Gll^Em, Rp^Es, Xu, Xu, Xu, Xu, Xu, Xu, Xu, Xu, Xu^Qhh
Hh^Fdw, Gs^Fmw, Hhd^Es, Rd^Es, Gd^Fmw, Gd^Fdw, Ww, Hh^Em, Gs^Fmw, Hh^Fmw, Gd^Fp, Gll^Fmf, Gd^Fp, Re^Em, Re, Gd^Fmw, Gll^Fmf, Re, Re, Re, Re, Re, Rp^Es, Gll^Fp, Gll^Fp, Gll^Fp, Gll^Fp, Gll^Fp, Xu, Xu, Gll^Fdw, Rp, Rp, Chr^_mhh, Gll^Fdw, Xu, Gll, Gll^Fdw, Gll^Fdw, Xu^Qhh
Mm, Hh^Em, Gs^Fmw, Hhd^Edb, Gd^Fp, Gd^Fmw, Gs^Fmw, Hh^Em, Hh^Fmw, Mm, Md, Gd^Fp, Re^Em, Gll^Emf, Gll^Fmf, Gll^Fdf, Gll^Fmf, Re, Gll^Fp, Gll^Fmf, Wwg, Gll^Fp, Gll^Fp, Gll^Fp, Mm, Gll^Fp, Xu, Gll^Fp, Mm, Xu, Chr, Rp, Gll, Rp^Es, Gll, Gll, Gll, Gll^Fdw, Gll^Fdw, Xu^Qhh
Mm, Mm, Mm, Gll^Fmf, Hh^Fmw, Gs^Fmw, Gd^Fmw, Gd^Fmw, Hhd^Fmw, Md, Md, Gd^Fp, Hhd^Fdw, Hhd^Fdw, Gll^Fmw, Gll^Fdw, Gll^Fmf, Re^Es, Gll^Em, Gll^Emf, Gll^Fp, Gll^Fp, Gll^Fp, Gll^Fp, Mm, Gll^Fmf, Gll^Fp, Mm, Xu, Xu, Xu, Gll^Fdw, Gll, Gll, Gll, Gll, Gll, Gll^Fdw, Gll, Gll
Mm, Mm, Mm, Hh^Es, Mm, Gd^Fmw, Ww, Gd^Fmw, Hhd^Fmf, Gll^Fp, Hhd^Fmw, Hhd, Gll^Fdw, Ss^Vhs, Sm^Em, Gll^Em, Gll^Fmw, Gll^Fmw, Rb, Gll^Fmw, Gll^Fp, Gll^Fp, Gll^Fp, Mm, Gll^Fp, Xu, Xu, Xu, Xu, Xu, Xu, Gll^Fdw, Xu, Gll, Gll, Gll, Gll, Gll, Xu, Xu
