Rb, Rb, Aa, Rb, Aa, Rb, Gs^Vwm, Gs^Eff, Gs^Edt, Aa^Esa, Rb, Aa^Qhh, Cea^Qhh, Aa^Qhh, Aa^Qhh, Rb^Gvs, Rb^Gvs, Rb^Gvs, Rb^Gvs, Rb^Gvs, Rb, Re, Re^Gvs, Rb^Gvs, Re^Gvs, Aa, Gd, Gd, Gs, Gs, Aa, Aa^Qhu
Re, Rb, Aa, Aa, Aa^Edt, Ce^Edt, Rp^Ebn, Gs, Rp, Rb, Aa^Edt, Ce^Qhh, Ket^Qhh, Aa^_mh, Cea, Rb^Qhh, Rb^Gvs, Rb^Qhh, Rb^Qhh, Rb^Qhh, Rb^Qhh, Rb^Gvs, Rb^Gvs, Rb^Gvs, Rb^Gvs, Rb^Gvs, Rb, Gd^Es, Gs, Gs, Rb^Gvs, Rb
Aa, Gd, Aa, Aa, Ce, Ce^Edt, Rb^Edt, Rb^Es, Rb, Gs^Ebn, Aa^Edt, Aa^Vhca, Aa^Vhca, Cea^Qhh, Cea^Qhh, Aa^Edt, Rb^Gvs, Rb^Gvs, Aa, Rb^Gvs, Aa, Rb^Qhh, Rb^Qhh, Rb^Gvs, Rb^Gvs, Rb^Gvs, Gs^Eff, Gs, Re, Re^Gvs, Re^Gvs, Re^Gvs
Ai, Aa^Esa, Aa^Esa, Ce, Ai, Gs^Vh, Gs^Es, Aa^Vha, Aa, Rb, Wwg, Ai, Ai, Ai, Ai, Gs^Qhh, Gd^Qhh, Aa^Qhh, Aa^Qhh, Aa^Qhh, Gd^Qhh, Re^Gvs, Rb^Gvs, Rb^Qhh, Gd^Qhh, Gs^Eff, Gs^Eff, Rb^Gvs, Rb^Gvs, Rb^Gvs, Rb^Gvs, Re^Gvs
Wwg, Ai, Wwg, Wwg, Wwg, Wwg, Wwg, Aa, Wwg^Bw\, Wwg, Ai, Ai, Wwg, Ai, Ai, Ai, Wwg, Ai, Ai, Ai, Ai, Gd^Qhh, Gd^Qhh, Gs^Qhh, Gs^Vh, Gd^Eff, Gs, Gs^Vwm, Rb^Gvs, Rb^Gvs, Rb^Gvs, Aa
Wwg, Wog, Wog, Wog, Wog, Wog, Wog, Wwg, Wog, Wwg^Bw\, Gs, Ai, Gs, Wwg, Wwg, Wog, Wog, Wog, Wog, Ai, Wog, Wwg, Ai, Ai^Qhh, Ai^Qhh, Gd, Gd, Rb^Es, Aa, Aa, Aa, Aa
Aa, Wwg, Wwg, Wwg, Wwg, Wog, Wwg, Wog, Ai, Ai, Rb^Vh, Gs, Gd, Rb^Vh, Gd, Wwg, Wwg, Wwg, Wwg, Wwg, Wog, Wog, Wog, Wwg, Wwg, Ai, Wwg, Gd, Gs, Aa^Esa, Aa, Aa
Aa, Hhd^Fmw, Aa, Aa^Esa, Aa, Wwg, Aa, Wwg, Gd^Fp, Gs, Re, Gd, Ce, Ce, Gs^Fmf, Gd, Gs^Efm, Gs, Gs^Efm, Gs, Gs, Wwg, Wwg, Wwg, Wwg, Wog, Wog, Wwg, Wog, Wwg, Ai, Rb
Aa^Esa, Aa, Aa^Esa, Aa, Aa, Aa, Aa, Re, Gs^Fp, Gs^Em, Gs^Efm, Re, Gs^Fdw, Gs^Efm, Re^Em, Gs^Fmf, Gs^Fdw, Gs^Efm, Gs^Efm, Gs, Gs, Aa, Aa, Ai, Ai, Wwg, Ai, Wog, Ai, Wog, Wog, Ai
Aa, Re, Gs, Aa, Gd, Aa, Gs, Re^Es, Re^Es, Gs^Fmw, Re, Re^Es, Re, Re^Em, Gs^Fmf, Re, Re^Em, Re^Em, Re, Gs, Re^Em, Gs, Aa, Aa, Aa, Ai, Ai, Ai, Ai, Wwg, Ai, Wog
Aa, Aa, Aa, Gs, Gs, Gd, Gd, Gs, Gs^Fp, Re, Gs^Fmw, Gs^Fp, Re^Es, Gs^Fdw, Hh^Em, Gs^Fmw, Aa^Fpa, Aa^Fda, Gs^Fmf, Re, Gd, Gs, Aa, Aa, Re, Aa^Esa, Aa, Aa, Aa^Esa, Wwg, Ai, Wwg
Gd^Em, Aa, Aa, Re, Gd, Gd, Gs^Efm, Aa, Re^Em, Re^Es, Aa, Aa, Gs^Fmf, Re, Re^Es, Aa, Aa^Fpa, Aa, Re^Em, Re^Em, Re, Aa, Aa, Gd^Fmf, Re, Aa^Esa, Aa, Re^Es, Aa, Aa^Esa, Aa^Esa, Ai
Gd^Es, Gs^Efm, Gs^Fmw, Re^Em, Re, Gs^Fp, Aa, Aa, Aa^Fda, Aa^Esa, Aa^Fpa, Aa, Gs^Fmf, Gs^Fmw, Gs^Fmf, Re, Re^Em, Aa, Aa^Fda, Aa^Fpa, Re^Es, Gd, Re^Em, Re, Gll^Fp, Re^Es, Gll^Fdw, Aa, Wwg, Aa, Ai, Aa
Gll^Fda, Ha^Fda, Ha^Fda, Hh^Fp, Gs^Fp, Re, Aa, Aa^Fpa, Aa^Fpa, Aa^Fda, Ww^Ewf, Gs^Fmf, Gs^Efm, Gs^Fmf, Gs^Fmw, Gs^Fmf, Re, Aa^Fda, Aa^Fda, Aa^Fpa, Gll^Fmw, Re, Gll^Fp, Gll^Em, Re^Es, Re^Es, Gll^Em, Ss^Em, Ss^Emf, Ss^Em, Ai, Aa
Aa^Fpa, Aa^Fda, Aa, Hh^Emf, Re^Em, Re^Em, Aa^Esa, Aa^Fpa, Aa, Ww^Ewl, Ww, Ww^Ewf, Gs^Efm, Gs^Fmf, Re^Em, Re, Gs^Efm, Re^Em, Gll^Fmf, Aa^Em, Gll^Fmw, Gll^Em, Gll^Emf, Gs^Vl, Re^Es, Gll^Fdw, Re^Es, Ss^Em, Gll^Fdw, Wwg^Edb, Sm^Edb, Sm^Tf
Aa^Fpa, Aa, Aa^Fpa, Aa, Re, Hh^Fmf, Aa, Aa, Aa^Fda, Gs^Fmf, Gll^Emf, Gs^Fmf, Gs^Fmw, Re^Em, Gs^Fmw, Gs^Fmf, Gll^Fmw, Re^Em, Re^Em, Gll^Fp, Gll^Fmw, Gll^Fmw, Gll^Fp, Gll^Fp, Gll^Fmw, Re, Hhd^Fdw, Re^Es, Hhd^Fdw, Ss^Em, Sm, Sm^Emf
Ha^Fda, Ha^Fda, Hh^Em, Gs^Fmw, Re, Gs^Fp, Re, Aa, Aa, Gll^Em, Gd^Fmf, Gd^Fmf, Re^Es, Re, Gs^Fmf, Gll^Emf, Gll^Em, Gll^Fmw, Gll^Fmw, Re, Re^Em, Re, Re, Gs^Efm, Gll^Fdw, Gs^Vl, Re^Es, Re^Es, Hhd^Fmw, Ss^Em, Ss^Em, Ss^Em
Gll^Em, Ha^Fda, Gs^Fmw, Re^Es, Aa, Re^Es, Aa, Aa, Aa, Re^Em, Gd^Fmw, Re, Gd^Fmf, Gd^Em, Gll^Fp, Gs^Fp, Gs^Efm, Gs^Fmw, Gll^Fmf, Gs^Fmw, Re^Em, Gs^Fp, Gs^Fmf, Re^Em, Re, Re^Em, Gll^Fmw, Hhd^Fmw, Hhd^Fp, Gll^Fmw, Sm^Em, Sm^Emf
Gll^Fdf, Gll^Fmf, Gd^Fmf, Re^Es, Gd^Em, Aa, Ww^Ewl, Aa, Aa, Re, Re^Es, Re, Re^Es, Gs^Fmw, Re, Re^Em, Re^Em, Gs^Efm, Re^Em, Re, Gs^Fmf, Gs^Fmw, Gll^Fdf, Gs^Fp, Re^Em, Gs^Em, Hh^Fp, Gll^Fp, Hhd^Fmw, Hhd^Fdw, Hhd^Fdw, Ss^Tf
Gll^Fdf, Gs^Fmw, Gd^Em, Re, Gd^Fmf, Ww^Ewl, Aa, Aa, Gd^Em, Aa^Esa, Aa, Aa^Esa, Gs^Fmw, Re^Es, Gs^Fmf, Gs^Fmf, Re, Gs^Fmw, Re, Gs^Fmf, Gs^Fp, Gll^Fdf, Gll^Fmf, Gll^Fmf, Re, Gll^Fmw, Gs^Em, Gg, Gll^Fmw, Ss^Em, Gll^Fmw, Gll^Emf
Gll^Fmf, Gd^Fmf, Gd^Fp, Re^Es, Re^Es, Gd^Fdf, Re^Es, Re, Re^Es, Re, Re, Re, Re^Em, Re, Gll^Em, Gll^Fmf, Gll^Fmw, Re^Em, Gs^Fmf, Re^Em, Re, Re^Em, Re^Es, Gs^Fp, Gll^Fmf, Re^Em, Re, Gs^Fp, Gll^Fmw, Gll^Fmw, Hhd^Emf, Gll^Fmw
Gll^Fmf, Gs^Fmw, Gd^Fmf, Gd^Fp, Gd^Fmw, Re, Gd^Fmf, Gd^Fmf, Re^Es, Gd^Fmw, Gs^Fmf, Gs^Fmw, Re, Gs^Vl, Gs^Fmw, Gll^Fmf, Gs^Fmf, Gs^Fmf, Gll^Fmw, Gs^Fdf, Gll^Fp, Gll^Fmf, Re, Gll^Fmw, Gs^Fp, Gll^Fmw, Re^Em, Gg, Hh^Fdw, Hh^Fdw, Gll^Fmw, Gll^Fmw
Gll^Fmw, Gll^Fp, Gll^Emf, Gll^Em, Re, Re^Es, Gs^Fmw, Gd^Fmw, Gd^Fp, Re^Es, Re, Re^Es, Gd^Fmw, Re^Es, Gd^Fp, Gs^Efm, Re^Em, Re^Em, Re, Gll^Fmf, Gll^Fmw, Gd^Fp, Re, Gs^Fmf, Re^Es, Re, Gll^Fmw, Gg, Aa^Fda, Ha^Em, Ms, Gll^Fmw
Gll^Fdf, Gll^Fp, Gll^Fp, Gs^Fmw, Re, Gs^Fp, Gs^Efm, Gs^Fp, Gs^Fp, Gs^Fmw, Re, Gs^Fmw, Gd^Em, Re, Re^Es, Gd^Fmw, Re, Gll^Fp, Gll^Fmw, Re^Em, Gd^Fp, Re^Es, Gd^Fmw, Re^Es, Re^Fmw, Gd^Fp, Gd^Fp, Aa, Ha^Em, Hh^Fdw, Ms, Hh^Fdw
Gll^Fmf, Gs^Fdf, Gll^Fmf, Re^Em, Gs^Fp, Re, Re^Em, Gs^Vl, Gs^Fmw, Gs^Fmw, Gll^Fmw, Re^Em, Re^Em, Gd^Fmw, Gll^Fp, Re^Es, Gll^Em, Gll^Fmf, Gs^Fmw, Re, Gs^Fmw, Re, Gd^Fmw, Re, Gg^Fmf, Ha^Fda, Ha^Fda, Aa, Aa^Fda, Ms, Ms, Ms
Gll^Fmf, Gs^Fdf, Gll^Fmf, Re^Em, Re, Gs^Fmw, Re, Gll^Fmw, Gll^Em, Gs^Fp, Gs^Fp, Gs^Vl, Re^Em, Gd^Fmw, Gll^Fmf, Gll^Fp, Gll^Fp, Gll^Emf, Gll^Fp, Re, Re^Em, Re, Gd^Fmf, Re^Es, Gll^Fp, Aa^Fmf, Hhd^Fp, Ha^Fpa, Ms, Ms, Ha, Ms
Mm, Gs^Fmf, Hhd^Em, Gs^Fp, Gs^Fmf, Re^Em, Gs^Fmw, Gs^Fp, Gll^Fp, Gll^Emf, Gs^Fdf, Gd^Fmf, Re, Gd^Em, Gd^Fmw, Gll^Fp, Gll^Fdf, Gll^Fmf, Gll^Fmf, Gs^Fmw, Re, Gs^Fmw, Gll^Fp, Re^Es, Aa^Fda, Gll^Fdf, Ha^Fpa, Hhd^Fp, Ms, Ha, Ms, Ms
Hhd^Fdw, Hhd^Em, Hhd, Gs^Fmf, Hhd^Em, Re^Em, Re, Gll^Fp, Gll^Fmf, Gll^Fmf, Gs^Fdf, Gs^Fmf, Gd^Fp, Re, Gll^Fmf, Gll^Fp, Gll^Em, Gll^Fdf, Gll^Em, Gs^Fmw, Re, Gll^Em, Re^Em, Re^Es, Aa^Fda, Ha^Fda, Gll^Fdf, Ha^Fpa, Hhd^Fmw, Hh^Fmw, Ms, Ms
Mm, Mm, Hhd^Fmw, Hhd^Fdw, Gs^Fmw, Gs^Fmw, Re^Es, Gll^Fmw, Re, Gll^Em, Re, Gd^Fmf, Re, Re^Es, Gll^Fmf, Gll^Fdf, Gll^Fmf, Gll^Emf, Gll^Fp, Gll^Fp, Gll^Fmw, Re, Gll^Fmw, Gll^Fmf, Gll^Fp, Ha^Fda, Hhd^Fp, Ha^Fpa, Ms, Hh^Fmw, Ms, Ms
Hh^Em, Mm, Hhd^Fmw, Hhd^Em, Gll^Fp, Gs^Fmw, Gll^Em, Re^Es, Gll^Fp, Re, Gd^Fmw, Re^Es, Gd^Fmw, Gll^Fp, Gll^Fmf, Gll^Fmf, Gll^Em, Gll^Fmf, Gll^Fmw, Gll^Fp, Gll^Fp, Re^Em, Gll^Fdw, Ss, Gll^Fdw, Gll^Fdw, Hhd^Fmw, Ha^Fpa, Ms, Gll^Fp, Hh, Ha^Ewl
Hhd^Fdw, Mm, Gll^Fmw, Gll^Emf, Gll^Fmw, Gll^Fp, Gll^Fmf, Gll^Fmf, Gll^Fdf, Gll^Fmf, Gll^Fp, Re^Es, Re, Gll^Fmf, Gll^Fp, Gll^Fp, Gll^Fmw, Gll^Fmw, Re^Es, Gll^Fp, Re, Re^Em, Gll^Vhr, Ss^Edb, Ss^Edb, Sm, Gll^Fdw, Hhd^Fmw, Ha, Gll^Fmw, Ww^Edb, Ha
Gll^Fmw, Hhd^Fp, Hhd^Em, Hhd^Fp, Hhd^Fp, Gll^Em, Gll^Emf, Gll^Fdf, Gll^Fmf, Gll^Fmf, Gll^Fmf, Gll^Fp, Gll^Em, Re, Gll^Fmw, Gll^Fp, Gll^Fp, Re, Gll^Fp, Re^Es, Gll^Fmw, Gll^Emf, Ss^Edb, Ss^Edb, Sm^Em, Sm, Gd^Emf, Ss, Ss, Ha, Ww, Ww
Hhd^Fdw, Gll^Fp, Hhd^Fmw, Gll^Fp, Gll^Fmw, Gll^Fp, Gll^Fp, Hhd^Fp, Hhd^Fmf, Hhd^Fdf, Gll^Fmf, Gll^Fp, Gll^Emf, Re^Es, Re, Gll^Fp, Re^Em, Re^Em, Ss, Gll^Fp, Gll^Fmw, Ss^Edb, Ss^Edb, Gll^Fdw, Ss^Em, Sm^Tf, Gd^Emf, Ss, Wwg^Edb, Wwg, Gll^Fmw, Gll^Fp
Hhd^Fdw, Hhd^Fp, Gll^Emf, Hhd^Fmw, Hhd^Fp, Hhd^Fmw, Gll^Fmw, Gll^Fmf, Gll^Fmf, Hhd^Fdf, Gll^Fmf, Gll^Fmw, Gll^Fp, Gll^Em, Gll^Fp, Re, Gll^Fmw, Gll^Fdw, Gll^Em, Gll^Fdw, Sm^Emf, Gll^Fdw, Ss, Sm, Gll^Fdw, Ss^Em, Sm, Gd^Em, Wwg^Edb, Wwg^Edb, Gll^Fmw, Gll^Fmw
Hhd^Fdw, Gll^Fp, Hhd^Fmw, Gll^Fp, Gll^Fmw, Gll^Fp, Gll^Fp, Hhd^Fp, Hhd^Fmf, Hhd^Fdf, Gll^Fmf, Gll^Fp, Gll^Emf, Gll^Fp, Gll^Fp, Re^Es, Gll^Fmw, Ss, Ss, Ss^Tf, Gll^Fmw, Sm, Ss^Edb, Sm^Em, Ss^Em, Ss, Gd^Emf, Wwg^Edb, Wwg^Edb, Gd^Em, Gll^Fdw, Gd^Emf
Hhd^Fdw, Hhd^Fp, Gll^Emf, Hhd^Fmw, Hhd^Fp, Hhd^Fmw, Gll^Fmw, Gll^Fmf, Gll^Fmf, Hhd^Fdf, Gll^Fmf, Gll^Fmw, Gll^Fp, Gll^Em, Gll^Fp, Re^Es, Gll^Fmw, Gll^Fdw, Gll^Em, Gll^Fdw, Sm^Emf, Gll^Fdw, Ss, Sm, Gll^Fdw, Ss^Em, Sm, Gd^Em, Wwg^Edb, Wwg^Edb, Gll^Fmw, Sm^Em
Gll^Fmw, Hhd^Fmw, Gll^Em, Gll^Fp, Hhd^Fp, Gll^Fp, Hhd^Fmw, Gll^Fp, Hhd^Fmf, Hhd^Fdf, Gll^Em, Gll^Fmw, Gll^Fmw, Gll^Fp, Ce, Ce, Ce, Ss, Ss^Em, Ss^Tf, Sm^Em, Sm, Sm, Sm^Em, Gll^Fdw, Ss, Sm^Edb, Wwg^Edb, Gll^Fdw, Gd^Em, Gll^Fdw, Gg
Hhd, Hhd^Fp, Hhd^Fp, Hhd^Fmw, Mm, Gll^Fp, Gll^Em, Gll^Em, Hhd^Fp, Hhd^Fmf, Gll^Fmw, Gll^Fp, Gll^Fmw, Gll^Em, Gll^Fp, Ke, Gll^Fp, Gll^Fp, Gll^Fp, Ss^Emf, Ss^Em, Sm^Tf, Ss^Emf, Ss^Em, Wwg, Sm, Sm, Sm, Ss^Em, Gll^Fdw, Ss^Em, Gg
Mm, Gll^Fp, Mm, Mm, Mm, Gll^Fmw, Gll^Fmw, Gll^Emf, Hhd^Fmw, Gll^Fp, Hhd^Fp, Hhd^Fp, Hhd^Fp, Gll^Fp, Gll^Fp, Re, Gll^Fp, Gll^Em, Gll^Fdw, Gd^Em, Gll^Fdw, Ss^Emf, Gll^Fmw, Gll^Fp, Wwg, Wwg^Edb, Sm^Edb, Ss^Em, Ss^Emf, Ss^Tf, Gll^Fdw, Gg
Gg, Hhd^Fp, Gg, Mm, Gg, Hhd^Fp, Gll^Em, Gll^Fp, Hhd^Fp, Gll^Fmf, Gll^Fmf, Gll^Fmf, Hhd^Fp, Gll^Fmw, Re^Es, Re, Gll^Fmw, Gll^Fp, Gll^Fmw, Gll^Fdw, Ss^Emf, Gll^Fdw, Gll^Fdw, Gll^Fmw, Gll^Fp, Wwg^Edb, Wwg^Edb, Sm, Ss^Em, Gll^Fdw, Gg, Gg
