Aa^Esa, Aa, Aa^Esa, Aa, Aa, Aa^Esa, Aa^Esa, Aa, Aa, Gs, Gd, Gs, Rb, Rb, Gs^Es, Gs, Aa, Aa, Aa, Aa, Aa, Aa, Aa, Aa, Aa, Gd, Aa, Aa, Aa, Aa, Aa, Aa
Aa, Aa^Esa, Aa^Esa, Aa, Rb, Aa^Esa, Rb, Aa, Gs, Gd^Em, Gd, Gs, Rb, Gs^Es, 1 Gs^Es, Aa, Gs^Eff, Aa, Gs, Gs^Vh, Aa, Aa^Esa, Aa, Aa^Esa, Aa, Aa, Aa, Aa, Aa, Aa, Aa^Es, Aa
Aa, Aa, Rb, Rb, Re, Rb, Rb, Re^Edt, Aa^Eff, Gs, Gs^Es, Rb, Gd^Edt, Gd, Rb^Gvs, Re^Eff, Rb^Gvs, Gs^Eff, Gs^Eff, Aa, Aa, Aa, Gs, Gs, Gs, Gd^Vh, Gd, Ce, Ce, Aa, Aa, Aa
Rb, Aa, Rb, Aa, Rb, Re, Re^Edt, Re^Edt, Aa^Eff, Aa^Eff, Rb, Gd, Gd, Gs, Aa, Rb^Gvs, Rb^Gvs, Rb^Gvs, Rb^Gvs, Gs^Eff, Gs^Eff, Aa, Re^Gvs, Gd, Aa, Aa, Aa, Ce, Gs, Aa, Aa, Aa
Rb, Rb, Aa, Rb, Aa, Rb, Gs^Vh, Gs^Eff, Gs^Edt, Aa^Esa, Rb, Gd, Rr^Vhc, Aa, Aa, Rb^Gvs, Rb^Gvs, Rb^Gvs, Rb^Gvs, Rb^Gvs, Rb, Re, Re^Gvs, Rb^Gvs, Re^Gvs, Aa, Gd, Gd, Gs, Gs, Aa, Aa
Re, Rb, Aa, Aa, Aa^Edt, Ce^Edt, Rp^Ebn, Gs, Rp, Rb, Rb^Edt, Ch, Kh, Aa^Edt, Aa, Rb^Gvs, Rb^Gvs, Rb^Gvs, Rb, Rb, Rb, Rb^Gvs, Rb^Gvs, Rb^Gvs, Rb^Gvs, Rb^Gvs, Rb, Gd^Es, Gs, Gs, Rb^Gvs, Rb
Aa, Gd, Aa, Aa, Ce, Ce^Edt, Rb^Edt, Rb^Es, Rb, Gs^Ebn, Rr^Vhc, Ch^Edt, Ch, Ch, Ch^Edt, Aa^Edt, Rb^Gvs, Rb^Gvs, Aa, Rb^Gvs, Aa, Rb^Gvs, Rb^Gvs, Rb^Gvs, Rb^Gvs, Rb^Gvs, Gs^Eff, Gs, Re, Re^Gvs, Re^Gvs, Re^Gvs
Ai, Aa^Esa, Aa^Esa, Ce, Ai, Gs^Vh, Gs^Es, Rb^Vh, Rp, Rb, Wwg, Ai, Ai, Ai, Ai, Gs^Edt, Gd, Aa^Esa, Aa, Aa, Gd, Re^Gvs, Rb^Gvs, Rb^Gvs, Gd, Gs^Eff, Gs^Eff, Rb^Gvs, Rb^Gvs, Rb^Gvs, Rb^Gvs, Re^Gvs
Wwg, Ai, Wwg, Wwg, Wwg, Wwg, Wwg, Rp^Edt, Wwg^Bw\, Wwg, Ai, Ai, Wwg, Ai, Ai, Ai, Wwg, Ai, Ai, Ai, Ai, Gd, Gd, Gs, Gs^Vh, Gd^Eff, Gs, Gs^Wm, Rb^Gvs, Rb^Gvs, Rb^Gvs, Aa
Wwg, Wog, Wog, Wog, Wog, Wog, Wog, Wwg, Wog, Wwg^Bw\, Gs, Ai, Gs, Wwg, Wwg, Wog, Wog, Wog, Wog, Ai, Wog, Wwg, Ai, Ai, Ai, Gd, Gd, Rb^Es, Aa, Aa, Aa, Aa
Gs, Wwg, Wwg, Wwg, Wwg, Wog, Wwg, Wog, Ai, Ai, Rb^Vh, Gs, Gd, Rb^Vh, Gd, Wwg, Wwg, Wwg, Wwg, Wwg, Wog, Wog, Wog, Wwg, Wwg, Ai, Wwg, Gd, Gs, Aa^Esa, Aa, Aa
Gs, Gs, Gs, Gs, Gs, Wwg, Gs, Wwg, Gs, Gs, Gd, Gd, Ce, Ce, Gd, Gd, Gd, Gs, Gs, Gs, Gs, Wwg, Wwg, Wwg, Wwg, Wog, Wog, Wwg, Wog, Wwg, Ai, Rb
Gs, Gs, Gs, Gs, Gs, Gs, Gs^Es, Gs, Gs, Gs, Gs, Gs, Gs, Gd, Gd, Gs, Gs, Gs, Gs, Gs, Gs, 2 Gs, Gs, Gs, Gs, Wwg, Ai, Wog, Ai, Wog, Wog, Ai
Gs, Gs, Gs, Gs, Gs, Gs, Gs, Gs, 3 Gs, Gs, Gs, Gs, Gs, Gs, Gs, Gs, Gs, Gs, Gs, Gs, Gs, Gs, Gs, Gs, Gs, Gs, Gs, Ai, Ai, Wwg, Ai, Wog
Gs, Gs, Gs, Gs, Gs, Gs, Gs, Gs, Gs, Gs, Gs, Gs, Gs, Gs, Gs, Gs, Gs, Gs, Gs, Gs, Gs, Gs, Gs, Gs, Gs, Gs, Gs, Gs, Gs, Wwg, Gs, Wwg
Gs, Gs, Gs, Gs, Gs, Gs, Gs, Gs, Gs, Gs, Gs, Gs, Gs, Gs, Gs, Gs, Gs, Gs, Gs, Gs, Gs, Gs, Gs, Gs, Gs, Gs, Gs, Gs, Gs, Gs, Gs, Gs
Gs, Gs, Gs, Gs, Gs, Gs, Gs, Gs, Gs, Gs, Gs, Gs, Gs, Gs, Gs, Gs, Gs, Gs, Gs, Gs, Gs, Gs, Gs, Gs, Gs, Gs, Gs, Gs, Gs, Gs, Gs, Gs
Gs, Gs, Gs, Gs, Gs, Gs, Gs, Gs, Gs, Gs, Gs, Gs, Gs, Gs, Gs, Gs, Gs, Gs, Gs, Gs, Gs, Gs, Gs, Gs, Gs, Gs, Gs, Gs, Gs, Gs, Gs, Gs
Gs, Gs, Gs, Gs, Gs, Gs, Gs, Gs, Gs, Gs, Gs, Gs, Gs, Gs, Gs, Gs, Gs, Gs, Gs, Gs, Gs, Gs, Gs, Gs, Gs, Gs, Gs, Gs, Gs, Gs, Gs, Gs
Gs, Gs, Gs, Gs, Gs, Gs, Gs, Gs, Gs, Gs, Gs, Gs, Gs, Gs, Gs, Gs, Gs, Gs, Gs, Gs, Gs, Gs, Gs, Gs, Gs, Gs, Gs, Gs, Gs, Gs, Gs, Gs
