Aa^Qhh, Aa^Qhh, Aa^Qhh, Aa^Qhh, Aa^Qhh, Aa^Qhh, Aa^Qhh, Aa^Qhh, Aa^Qhh, Gs^Qhh, Gd, Gs, Rb, Rb, Gs^Es, Gs, Aa, Aa, Aa, Aa, Aa, Aa, Aa^Qhux, Aa^Qhux, Aa^Qhux, Gd^Qhux, Aa^Qhux, Aa^Qhux, Aa^Qhux, Aa^Qhux, Aa^Qhux, Aa^Qhu
Aa^Qhh, Aa^Esa, Aa^_mh, Aa, Rb, Aa^Esa, Rb^Qhh, Aa^Qhh, Gs, Gd^Em, Ce, Gs, Rb, Gs^Es, Gs^Es, Aa, Gs^Eff, Aa, Gs, Gs^Vh, Aa, Aa^Esa, Aa, Aa^Qhux, Aa, Aa, Aa, Aa, Aa, Aa^Qhux, Aa^Qhux, Aa^Qhux
Aa^Qhh, Aa, Rb^Qhh, Re^Qhh, Re^Qhh, Rb^Qhh, Rb, Re^Edt, Aa^Eff, Gs, Gs^Es, Rb, Gd^Edt, Gd, Rb^Gvs, Re^Eff, Rb^Gvs, Gs^Eff, Gs^Eff, Aa, Aa, Aa, Gs, Gs, Gs, Gd^Vh, Gd, Ce, Ce, Aa, Aa^Qhux, Aa^Qhux
Rb^Qhh, Aa^Qhh, Rb, Aa, Rb, Re, Re^Edt, Re^Edt, Aa^Eff, Aa^Eff, Rb, Gd, Gd^Qhh, Gs, Aa, Rb^Gvs, Rb^Gvs, Rb^Gvs, Rb^Gvs, Gs^Eff, Gs^Eff, Aa, Re^Gvs, Gd, Aa, Aa, Aa, Ce, Gs, Aa, Aa, Aa^Qhux
Rb, Rb, Aa, Rb, Aa, Rb, Gs^Vh, Gs^Eff, Gs^Edt, Aa^Esa, Rb, Gd^Qhh, Rr^Vhc, Aa^Qhh, Aa^Qhh, Rb^Gvs, Rb^Gvs, Rb^Gvs, Rb^Gvs, Rb^Gvs, Rb, Re, Re^Gvs, Rb^Gvs, Re^Gvs, Aa, Gd, Gd, Gs, Gs, Aa, Aa^Qhux
Re, Rb, Aa, Aa, Aa^Edt, Ce^Edt, Rp^Ebn, Gs, Rp, Rb, Rb^Edt, Ch^Qhh, Kh^_mh, Aa^Edt, Ch, Rb^Qhh, Rb^Gvs, Rb^Qhh, Rb^Qhh, Rb^Qhh, Rb^Qhh, Rb^Gvs, Rb^Gvs, Rb^Gvs, Rb^Gvs, Rb^Gvs, Rb, Gd^Es, Gs, Gs, Rb^Gvs, Rb
Aa, Gd, Aa, Aa, Ce, Ce^Edt, Rb^Edt, Rb^Es, Rb, Gs^Ebn, Rr^Vhc, Ch^Qhh, Ch^Qhh, Ch^Qhh, Ch^Qhh, Aa^Edt, Rb^Gvs, Rb^Gvs, Aa, Rb^Gvs, Aa, Rb^Qhh, Rb^Qhh, Rb^Gvs, Rb^Gvs, Rb^Gvs, Gs^Eff, Gs, Re, Re^Gvs, Re^Gvs, Re^Gvs
Ai, Aa^Esa, Aa^Esa, Ce, Ai, Gs^Vh, Gs^Es, Rb^Vh, Rp, Rb, Wwg, Ai, Ai, Ai, Ai, Gs^Qhh, Gd^Qhh, Aa^Qhh, Aa^Qhh, Aa^Qhh, Gd^Qhh, Re^Gvs, Rb^Gvs, Rb^Qhh, Gd, Gs^Eff, Gs^Eff, Rb^Gvs, Rb^Gvs, Rb^Gvs, Rb^Gvs, Re^Gvs
Wwg, Ai, Wwg, Wwg, Wwg, Wwg, Wwg, Rp^Edt, Wwg^Bw\, Wwg, Ai, Ai, Wwg, Ai, Ai, Ai, Wwg, Ai, Ai, Ai, Ai, Gd^Qhh, Gd^Qhh, Gs^Qhh, Gs^Vh, Gd^Eff, Gs, Gs^Vwm, Rb^Gvs, Rb^Gvs, Rb^Gvs, Aa
Wwg, Wog, Wog, Wog, Wog, Wog, Wog, Wwg, Wog, Wwg^Bw\, Gs, Ai, Gs, Wwg, Wwg, Wog, Wog, Wog, Wog, Ai, Wog, Wwg, Ai, Ai^Qhh, Ai^Qhh, Gd, Gd, Rb^Es, Aa, Aa, Aa, Aa
Aa, Wwg, Wwg, Wwg, Wwg, Wog, Wwg, Wog, Ai, Ai, Rb^Vh, Gs, Gd, Rb^Vh, Gd, Wwg, Wwg, Wwg, Wwg, Wwg, Wog, Wog, Wog, Wwg, Wwg, Ai, Wwg, Gd, Gs, Aa^Esa, Aa, Aa
Aa, Hhd^Fmw, Aa, Aa^Esa, Aa, Wwg, Aa, Wwg, Gd^Fp, Gs, Re, Gd, Ce, Ce, Gs^Fmf, Gd, Gs^Efm, Gs, Gs^Efm, Gs, Gs, Wwg, Wwg, Wwg, Wwg, Wog, Wog, Wwg, Wog, Wwg, Ai, Rb
Aa^Esa, Aa, Aa^Esa, Aa, Aa, Aa, Aa, Re, Gs^Fp, Gs^Em, Gs^Efm, Re, Gs^Fdw, Gs^Efm, Re^Em, Gs^Fmf, Gs^Fdw, Gs^Efm, Gs^Efm, Gs, Gs, Aa, Aa, Aa, Aa, Wwg, Ai, Wog, Ai, Wog, Wog, Ai
Aa, Re, Gs, Aa, Gd, Aa, Gs, Re^Es, Re^Es, Gs^Fmw, Re, Re^Es, Re, Re^Em, Gs^Fmf, Re, Re^Em, Re^Em, Re, Gs, Re^Em, Gs, Aa, Aa, Aa, Aa, Aa, Ai, Ai, Wwg, Ai, Wog
Aa, Aa, Aa, Gs, Gs, Gd, Gd, Gs, Gs^Fp, Re, Gs^Fmw, Gs^Fp, Re^Es, Gs^Fdw, Hh^Em, Gs^Fmw, Aa^Fpa, Aa^Fda, Gs^Fmf, Re, Gd, Gs, Aa, Aa, Re, Aa^Esa, Aa, Aa, Aa^Esa, Wwg, Aa, Wwg
Gd^Em, Aa, Aa, Re, Gd, Gd, Gs^Efm, Aa, Re^Em, Re^Es, Aa, Aa, Gs^Fmf, Re, Re^Es, Aa, Aa^Fpa, Aa, Re^Em, Re^Em, Re, Aa, Aa, Gd^Fmf, Re, Aa^Esa, Aa, Re^Es, Aa, Aa^Esa, Aa^Esa, Aa
Gd^Es, Gs^Efm, Gs^Fmw, Re^Em, Re, Gs^Fp, Aa, Aa, Aa^Fda, Aa^Esa, Aa^Fpa, Aa, Gs^Fmf, Gs^Fmw, Gs^Fmf, Re, Re^Em, Aa, Aa^Fda, Aa^Fpa, Re^Es, Gd, Re^Em, Re, Gll^Fp, Re^Es, Gll^Fdw, Aa, Wwg, Aa, Ai, Aa
Gll^Fda, Ha^Fda, Ha^Fda, Hh^Fp, Gs^Fp, Re, Aa, Aa^Fpa, Aa^Fpa, Aa^Fda, Ww^Ewf, Gs^Fmf, Gs^Efm, Gs^Fmf, Gs^Fmw, Gs^Fmf, Re, Aa^Fda, Aa^Fda, Aa^Fpa, Gll^Fmw, Re, Gll^Fp, Gll^Em, Re^Es, Re^Es, Gll^Em, Ss^Em, Ss^Emf, Ss^Em, Ai, Aa
Aa^Fpa, Aa^Fda, Aa, Hh^Emf, Re^Em, Re^Em, Aa^Esa, Aa^Fpa, Aa, Ww^Ewl, Ww, Ww^Ewf, Gs^Efm, Gs^Fmf, Re^Em, Re, Gs^Efm, Re^Em, Gll^Fmf, Aa^Em, Gll^Fmw, Gll^Em, Gll^Emf, Gs^Vl, Re^Es, Gll^Fdw, Re^Es, Ss^Em, Gll^Fdw, Wwg^Edb, Sm^Edb, Sm^Tf
Aa^Fpa, Aa, Aa^Fpa, Aa, Re, Hh^Fmf, Aa, Aa, Aa^Fda, Gs^Fmf, Gll^Emf, Gs^Fmf, Gs^Fmw, Re^Em, Gs^Fmw, Gs^Fmf, Gll^Fmw, Re^Em, Re^Em, Gll^Fp, Gll^Fmw, Gll^Fmw, Gll^Fp, Gll^Fp, Gll^Fmw, Re, Hhd^Fdw, Re^Es, Hhd^Fdw, Ss^Em, Sm, Sm^Emf
Ha^Fda, Ha^Fda, Hh^Em, Gs^Fmw, Re, Gs^Fp, Re, Aa, Aa, Gll^Em, Gd^Fmf, Gd^Fmf, Re^Es, Re, Gs^Fmf, Gll^Emf, Gll^Em, Gll^Fmw, Gll^Fmw, Re, Re^Em, Re, Re, Gs^Efm, Gll^Fdw, Gs^Vl, Re^Es, Re^Es, Hhd^Fmw, Ss^Em, Ss^Em, Ss^Em
Gll^Em, Ha^Fda, Gs^Fmw, Re^Es, Aa, Re^Es, Aa, Aa, Aa, Re^Em, Gd^Fmw, Re, Gd^Fmf, Gd^Em, Gll^Fp, Gs^Fp, Gs^Efm, Gs^Fmw, Gll^Fmf, Gs^Fmw, Re^Em, Gs^Fp, Gs^Fmf, Re^Em, Re, Re^Em, Gll^Fmw, Hhd^Fmw, Hhd^Fp, Gll^Fmw, Sm^Em, Sm^Emf
