Xu, Xu, Xu, Re^Em, Xu, Xu, Aa^Fda, Aa^Vca, Rp, Rp^Edt, Chr, Rp^Edt, Aa^Fda, Gll^Fdw, Chr, Xu, Xu, Xu, Xu, Xu, Xu^Qhu, Xu^Qhu, Ww^Qhu, Ww^Qhu, Wo^Qhu, Wo^Qhu, Wo^Qhu, Wo^Qhu, Wo^Qhu, Wo^Qhu, Xu^Qhu, Xu, Xu, Xu, Xu, Xu
Xu, Xu, Xu, Xu, Xu, Xu, Aa^Fdw, Xu, Chr, 1 Khr, Chr^Edt, Chr^Edt, Aa, Aa, Xu, Xu, Uh^Qhh, Xu, Uh^Emf, Xu, Xu^Qhu, Ww^Ewl, Ww^Ewl, Ww, Wwrt, Wo, Ww, Wo, Ww, Xu^Qhu, Xu^Qhu, Xu, Xu, Xu, Xu, Xu
Xu, Xu, Xu, Xu, Qxu, Xu, Xu, Aa, Aa, Rp, Rp, Chr, Ur, Xu, Ur^Es, Uu^Em, Uu^Vud, Uh^Qhh, Xu, Cud, Cud, Ww^Qhu, Ww^Qhu, Wwrt, Wwrt, Ww, Wwrt, Ww^_ml, Ww, Ww, Xu^Qhu, Xu, Xu, Xu, Xu, Xu
Xu, Xu, Qxu, Qxu, Qxu, Qxu, Qxu, Rp^Qhu, Rp^Qhu, Uu^Qhu, Uu^Qhu, Ur, Ur, Ur^Ii, Xu, Ur^Es, Ur, Ur^Ii, Cud, Kud, Cud, Ur^Es, Ur^Es, Ds^Qhu, Ds^Qhu, Ww^Ewl, Ww^Qhu, Ww^Ewl, Ww, Ww, Xu, Xu^Qhu, Xu, Xu, Xu, Xu
Xu, Xu, Qxu, Qxu, Qxu, Qxu, Qxu, Qxu, Qxu, Uh^Qhu, Qxu, Qxu, Qxu^Bs/, Uu^Em, Xu, Xu, Xu, Uh^Emf, Xu, Xu, Uu^Em, Uu^Em, Uu^Em, Rd^Es, Rd, Ds^Qhu, Rd^Es, Ww^Qhu, Ww^Qhu, Ww^Qhu, Xu, Xu^Qhu, Xu^Qhu, Xu, Xu, Xu
Xu, Xu, Xu, Qxu, Xu, Xu, Xuc, Xu, Xu, Qxu, Uh^Qhu, Qxu, Qxu, Uh^Em, Xu, Xu, Uh^Qhh, Uu^Qhu, Uu^Em, Xu, Uh^Emf, Uh^Tf, Uu^Em, Uu^Em, Rd^Es, Rd^Es, Ur^Es, Uu^Tf, Uu^Qhu, Uu^Qhu, Ss^Qhu, Xue, Xu^Qhu, Xu, Xu, Xu
Xu, Xu, Xu, Xu, Xu, Xu, Xu, Xu, Xu, Xu, Uu^Em, Uh^Em, Qxu, Qxu, Xu, Xu, Xu, Xu, Uu^Qhu, Uu^Ii, Rd, Xue, Ss^Qhu, Rd^Es, Ss^Qhu, Ds^Esd, Rd^Es, Uue^Vu, Uue, Xu, Ss^Qhu, Ss^Tf, Xue^Qhu, Xu, Xu, Xu
Xu, Xu, Xu, Xu, Xu, Xu, Xu, Qlf, Qlf, Uh^Em, Qlf, Uh^Qhu, Uh^Qhu, Uh^Qhh, Qxu, Qxu, Qxu^Bs/, Uu^Qhu, Rd^Ii, Xu, Wwg, Ss, Sm^Qhu, Sm^Qhu, Sm^Emf, Sm^Qhu, Uue^Qhh, Rd^Es, Uue, Ss^Qhu, Sm^Qhu, Ss^Emf, Xue^Qhu, Xue, Xu, Xu
Xu, Xu, Xuc, Xuc, Xu, Xu, Xu, Xu, Qlf, Qlf, Uu^Vu, Qlf, Uu^Tf, Uh^Em, Ur, Ur, Uh^Em, Qxu, Xu, Xu, Sm, Ww^Ewl, Ss^Em, Ss^Tf, Ss^Vhs, Uue^Qhh, Uue^Qhh, Rd^Es, Xu, Sm^Emf, Rb^Em, Ss^Qhu, Xue^Qhu, Xu, Xu, Xu
Xu, Xuc, Xuc, Xuc, Xu, Xu, Xu, Xu, Xu, Qlf, Qlf, Qlf^Bs\, Tb^Tf, Uu^Tf, Ur, Ur^Qhh, Uh^Em, Qxu, Xu, Xu, Xu, Sm^Em, Sm^Em, Wwg, Ss^Em, Xu, Uue^Qhh, Ur^Es, Uue^Qhu, Xu, Sm^Em, Xue, Xue, Xu, Xu, Xu
Xu, Xom, Xuc, Xuc, Xu, Xu, Xu, Xu, Xu, Xu, 2 Qlf, Qlf, Uu^Tf, Uu^Tf, Uu^Qhu, Uu^Qhu, Qxu, Qxu, Qxu, Xu, Xu, Sm^Emf, Ss^Em, Ww^Ewl, Ww^Ewl, Sm^Em, Uue^Em, Ur, Uue^Qhu, Ss^Qhu, Sm^Em, Sm^Emf, Ss^Qhu, Xue, Xu, Xu
Xu, Xuc, Xuc, Xuc, Xu, Xu, Xu, Xu, Xu, Qlf, Qlf, Tb^Tf, Uu^Tf, Uh^Em, Uu^Em, Uu^Qhu, Uh^Qhh, Qxu, Qxu, Xu, Xu, Ss^Em, Ww^Ewl, Wwg, Wwg, Wwg, Rd^Es, Rd^Es, Uh^Emf, Uu^Vu, Xue, Xue, Ss^Qhu, Xue, Xu, Xu
Xu, Xuc, Xu, Xuc, Xu, Xu, Xu, Xu, Xu, Xu, Qlf, Qlf, Qlf, Qlf, Qlf, Uh^Qhh, Qlf, Qxu, Qxu, Xu, Xu, Xu, Xu, Wo, Wo, Ww^Ewl, Xu, Cud, Kud, Cud, Xue, Ss^Qhu, Uue^Emf, Xue, Xu, Xu
Xu, Xu, Xuc, Xuc, Xuc, Xu, Xu, Xu, Xu, Xu, Xu, Qlf, Xu, Qlf, Qlf, Qlf, Qlf, Qlf, Qxu, Qxu, Xu, Xu, Xu, Wo, Wog^Edb, Wwg, Wwg^Vm, Xu, Cud, Cud, Uue^Qhu, Uue^Em, Uue^Qhu, Uu^Qhh, Xu, Xu
Xu, Xu, Xu, Xuc, Xu, Xu, Xu, Xu, Xu, Xu, Xu, Xu, Xu, Xu, Xu, Xu, Xu, Xu, Xu, Xu, Xu, Xu, Xu, Wo, Wwg, Wwg, Xom, Uu^Es, Uu^Tf, Ur, Uue^Emf, Uue^Tf, Uu^Qhh, Uu^Qhh, Xom, Xu
Xu, Xu, Xu, Xu, Xu, Xu, Xu, Xu, Xu, Xu, Xu, Xu, Xu, Xu, Xu, Xu, Xu, Xu, Xu, Xu, Wwg, Wog^Edb, Wog^Edb, Wog^Edb, Wwg^Edb, Wwg, Xom, Xom, Uu^Br\, Uu^Es, Ur^Br/, Ur^Br/, Uu^Br\, Xom, Xu, Xu
Xu, Xu, Xu, Xu, Xu, Xu, Xu, Xu, Xu, Xu, Xu, Xu, Xu, Xu, Xu, Xu, Xu, Xu, Xu, Xu, Sm^Em, Wwg^Edb, Wwg^Edb, Wwg, Sm^Edb, Wwg^Edb, Uu^Qhh, 4 Uu^Tf, Ur^Edb, Uu^Br|, Uu^Es, Uu^Edb, Xom, Xom, Xu, Xu
Xu, Xu, Xu, Xu, Xu, Xu, Xu, Xu, Xu, Xu, Xu, Xu, Xu, Xu, Xu, Xu, Xu^Qhh, Xu^Qhh, Xue^Qhh, Xue^Qhh, Sm^Em, Rb^Em, Ss, Sm, Ww^Ewl, Wwg^Vm, Ur^Edb, Ur^Edb, Uu^Qhu, Ur^Br|, Ur^Edb, Cud, Xom, Xu, Xu, Xu
Xu, Xu, Xu, Xu, Xu, Xu, Xu, Xu, Xu, Xu, Xu, Xu, Xu, Xu, Xu, Xue, Xue^Qhh, Xue^Qhh, Uh^Tf, Isa^Qhh, Sm^Qhh, Urb^Edb, Ss, Sm^Em, Urb^Edb, Wwg, Uue^Es, Uu^Qhu, Ur^Qhu, Ur^Br|, Uu^Br\, Xom, Xu, Xu, Xu, Xu
Xu, Xu, Xu, Xu, Xu, Xu, Xu, Xu, Xu, Xu, Xu, Xu, Xu, Xu, Xu, Xue^Qhh, Xu^Qhh, Uh^Em, Cud, Sm^Edb, Sm^Em, Isa^Qhh, Cud^Qhh, Urb^Edb, Urb^Edb, Wwg, Wwg^Edb, Uue^Edb, Ur, Xom, Uu^Br|, Xom, Xom, Xu, Xu, Xu
Xu, Xu, Xu, Xu, Xu, Xu, Xu, Xu, Xu, Xu, Xu, Xu, Xu, Xu, Xu, Xu, Xu^Qhh, Cud, Cud, Isa^Edb, Isa^Edb, Isa^Edb, Isa^Qhh, Urb, Urb^Edb, Urb^Edb, Wwg^Bw/r, Ss^Bw/r, Uue^Em, Uh^Em, Ur^Br|, Uu^Br\, Xom, Xom, Xu, Xu
Xu, Xu, Xu, Xu, Xu, Xu, Xu, Xu, Xu, Xu, Xu, Xu, Xu, Xu, Xu, Xu, Xu^Qhh, Xu^Qhh, Kud, Cud^_mh, Cud, Isa^Edb, Isa^Qhh, Isa^Qhh, Urb^Edb, Urb^Edb, Ss^Edb, Ss^Edb, Ss^Edb, Uue^Em, Xu, Uu^Br\, Xom, Xu, Xu, Xu
Xu, Xu, Xu, Xu, Xu, Xu, Xu, Xu, Xu, Xu, Xu, Xu, Xu, Xu, Xu, Xu, Xu, Xu^Qhh, Xu^Qhh, Cud, Isa^Edb, Isa^Edb, Isa^Qhh, Cud^Qhh, Urb^Edb, Urb^Edb, Ss^Edb, Ss^Vhs, Sm, Uue^Em, Xu, Xom, Xu, Xu, Xu, Xu
Xu, Xu, Xu, Xu, Xu, Xu, Xu, Xu, Xu, Xu, Xu, Xu, Xu, Xu, Xu, Xu, Xu^Qhh, Xu^Qhh, Cud, Cud, Isa^Edb, Isa^Edb, Isa^Qhh, Isa^Qhh, Urb^Edb, Ss^Em, Xu, Sm^Edb, Sm, Uue^Emf, Uu^Tf, Xu, Xu, Xu, Xu, Xu
Xu, Xu, Xu, Xu, Xu, Xu, Xu, Xu, Xu, Xu, Xu, Xu, Xu, Xu, Xu, Xu^Qhh, Xu^Qhh, Xu^Qhh, Uu^Em, Isa, Uh^Emf, Cud, Isa^Qhh, Urb^Edb, Urb^Edb, Urb^Edb, Xu, Xu, Uh^Vu, Ss^Bw/r, Xu, Uh^Vu, Sm^Qhh, Xu, Xu, Xu
Xu, Xu, Xu, Xu, Xu, Xu, Xu, Xu, Xu, Xu, Xu, Xu, Xu, Xu, Xu, Xu^Qhh, Xu^Qhh, Uh^Em, Uh^Em, Uu^Em, Uh^Emf, Xue^Qhh, Xue, Urb^Edb, Uh^Em, Uh^Tf, Uu^Emf, Uue, Ss^Qhu, Xu, Sm^Emf, Ss^Qhu, Xu, Xu, Xu, Xu
Xu, Xu, Xu, Xu, Xu, Xu, Xu, Xu, Xu, Xu, Xu, Xu, Xu, Xu, Xu, Xu, Xu, Xu^Qhh, Xu^Qhh, Xu^Qhh, Xu^Qhh, Xu^Qhh, Xu, Xue, Xu, Xu, Xu, Xu, Xu, Ss^Qhu, Xu, Sm^Qhh, Xu, Xu, Xu, Xu
Xu, Xu, Xu, Xu, Xu, Xu, Xu, Xu, Xu, Xu, Xu, Xu, Xu, Xu, Xu, Xu, Xu, Xu, Xu, Xu, Xu, Xu, Xu, Xu, Xu, Xu, Xu, Xu, Xu, Xu, Xu, Xu, Xu, Xu, Xu, Xu
