Aa^Qhh, Re^Qhh, Re^Qhh, Re^Qhh, Re^Qhh, Re^Qhh, Re^Qhh, Re^Qhh, Re^Qhh, Rb^Qhh, Rb^Qhh, Gg^Qhh, Gg^Qhh, Re, Re, Gs, Gd^Fms, Gd^Fms, Gd^Es, Ww, Ww, Ww, Ww, Ww, Re^Qhh, Gs^Qhh, Re^Qhh, Re^Qhh, Rb^Eff, Re^Qhh, Gg^Qhh, Gs^Qhh, Gs^Fdw, Rr^Es, Gg, Gs^Fdw, Gs^Fdw
Rb^Qhh, Re^Qhh, Re, Re, Re^Es, Re^Es, Re^Es, Rb^Es, Rb, Gs^_mh, Gs^Qhh, Rb^Qhh, Gg, Gd, Gd^Edt, Re^Es, Gd, Ce, Ww, Ww, Wo, Ww, Aa^Qhh, Gs^Qhh, Aa, Aa, Aa, Re, Re, Rb^Eff, Re^Eff, Gg, Gg, Gg, Gg, Gs^Fdw, Gg
Aa^Qhhf, Gg^Qhh, Gg, Re, Rb, Re^Es, Gs^Qhh, Rb, Gs^Qhh, Gs^Qhh, Gs, Gg^Es, Gg, Ce, Gd, Re, Gs^Edt, Gs, Ww, Wo, Ww, Ww, Aa^Qhh, Aa^_mh, Aa^Esa, Aa^Esa, Rb, Rb, Rb, Re^Es, Re, Gs^Eff, Gs^Wm, Gg, Re, Gg, Re
Aa^Qhhf, Gg^Qhh, Gs^Fms, Gg, Gg^Qhh, Gs^Qhh, Aa, Gg^Qhh, Aa^Eff, Gs^Eff, Gd^Eff, Gs, Gs^Eff, Gs^Eff, Gs^Fmw, Re, Re^Edt, Ww, Ww, Wo, Ww, Ww, Ww, Aa^Qhh, Aa^Qhh, Aa^Esa, Rb, Aa^Esa, Rb, Re, Gs^Edt, Aa, Re^Es, Re, Gs^Fdw, Re, Gs^Fds
Gs^Qhhf, Gs^Qhhf, Gg, Gs^Qhhf, Aa, Aa, Cea, Aa, Aa, Aa, Aa, Gd^Eff, Rb, Rb, Rb, Gs^Edt, Re, Ww, Cha^Edt, Ww, Ww, Ww, Ww, Ww, Ww, Ch^Qhh, Rr^Edt, Rb, Re^Edt, Gs, Re, Re, Aa, Aa^Es, Aa^Fda, Aa^Fda, Aa^Fda
Aa^Qhhf, Gg, Gg^Qhh, Gg^Qhh, Gg, Aa, Rb, Aa, Aa^Esa, Aa^Esa, Aa, Rb, Aa^Esa, Rb, Rb, Re, Gd^Vh, Aa^Fma, Aa^Fda, Aa, Rr^Vct, Ai, Ai, Ww, Ww^Bw/, Rr^Qhh, Gs^Qhh, Rr, Gg^Edt, Re, Gg^Fmw, Gs^Fdw, Aa^Fdw, Aa^Fda, Aa^Fdw, Aa^Fma, Aa^Fdw
Aa, Gg^Fms, Gg, Gg^Qhh, Aa, Rb, Rb, Re, Aa, Aa, Aa, Aa, Aa, Aa, Rb, Re, Re, Aa^Fdw, Rp, Cha, Cha^Edt, Ch, Rr, Ww^Bw/, Ww, Ww, Ww, Ch^Qhh, Aa^Qhh, Aa, Aa, Aa^Fmw, Gg^Fmw, Aa^Fma, Aa^Fda, Aa^Fdw, Aa^Fdw
Aa, Aa^Esa, Aa, Ce, Rb, Rb, Aa, Aa, Aa, Aa, Aa, Aa, Aa^Esa, Rb, Re, Aa^Vha, Re, Rp, Rp, Rr, Aa^Esa, Rr, Aa^Vhca, Rr, Wo, Wo, Ai, Ww, Ww, Gg^Qhh, Gg^Qhhf, Gs^Fmw, Aa^Vla, Aa^Fma, Aa^Fda, Aa^Fma, Ha^Fmw
Gg, Aa^Esa, Aa, Ce, Ce, Aa, Aa, Re, Aa^Vha, Aa, Aa, Re, Re^Es, Re, Gs, Re, Re, Rr, Isa^Ebn, Aa^Esa, Aa^Esa, Aa, Cha, Cha, 2 Kha, Wo, Wo, Ai, Ai, Ww, Gg^Qhh, Gg, Aa^Fma, Aa^Fma, Ha, Ha^Fma, Ha^Fdw
Aa, Aa, Aa, Aa^Esa, Aa, Ce, Rb, Rb, Re^Es, Re, Rb^Wm, Rb, Re^Eff, Re, Aa, Aa^Edt, Aa, Rr, Re, Re, Aa, Rr, Isa^Ebn, Ch^Edt, Ch, Wo^Bw\, Wo, Ai, Wo, Ww, Gg^Qhhf, Gs^Fmw, Hh^Fmw, Aa^Esa, Aa, Ha^Fma, Gg
Aa, Aa, Gg, Aa, Gg, Gs^Edt, Ce^Edt, Re, Re, Re, Re, Rb, Gs^Eff, Gs^Eff, Aa, Aa, Re, Re, Aa, Aa, Aa^Vhca, Aa^Esa, Aa^Edt, Aa, Aa^Edt, Ww^Bw\, Wo, Wo, Ww, Ds^Esd, Hd, Gg^Qhh, Gg, Aa, Ha^Fdw, Ha^Vhha, Ha
Rb, Re, Re, Gg^Fmw, Gg^Fmw, Aa, Cea, Ke, Gd, Re, Gd^Eff, Gs^Eff, Gs, Aa, Gs, Gs, Re, Aa^Esa, Aa^Fda, Aa^Fda, Rr, Rp, Aa^Vhca, Aa, Ww, Ww, Ww, Ww, Ds, Hd, Rd^Qhh, Gd^Qhh, Gg, Aa, Aa, Aa, Ha
Rb, Re, Re, Gg^Fdw, Aa^Fda, Aa^Es, Re, Ce, Gd^Edt, Gs, Gd, Gd, Gs, Gd, Gs, Gd, Rr, Re, Aa, Aa^Fda, Re, Gs^Fdw, Re, Aa^Fda, Ww, Ww, Ai, Ww, Wwr, Gg^Qhh, Gg, Gg, Hh, Gg^Qhh, Gg, Hh, Hh
Rb^Es, Rb^Es, Re, Re, Re, Re, Re, Gg, Re, Rb, Gs, Gd, Re, Gs, Re^Edt, Rr, Rr, Isa^Ebn, Rp^Edt, Rp^Edt, Re, Aa^Es, Aa^Edt, Aa, Aa, Ww, Ai, Ai, Ai, Rd^Qhh, Gg^Qhh, Hh, Hh, Gg, Gg, Gg, Gg
Re^Es, Re^Es, Gs^Fmw, Gs^Fmw, Gs^Fmw, Aa, Aa, Re^Es, Aa^Eff, Re^Eff, Re, Re, Aa, Re, Re, Cha^Edt, Aa^Vhca, Rp^Edt, Ch, Rp, Aa, Re^Es, Aa, Gs^Fdw, Aa^Fda, Wwr, Ai, Ai, Ai, Ww, Gg^Qhh, Gg, Hh, Hh, Gg, Gg, Aa
Gg, Gg, Aa^Fma, Aa^Fma, Aa, Aa, Aa^Eff, Aa^Eff, Re, Re, Aa, Aa, Aa^Esa, Re, Gg^Fmw, Aa^Esa, Aa^Esa, Aa^Vhca, Re, Re^Edt, Gs, Aa, Aa^Esa, Aa, Gs^Vh, Ai, Wwr, Ww, Wo, Ww, Ww, Gg^Qhh, Gg, Hh, Gg, Gg, Aa
Gg^Fmw, Gg^Fmw, Aa^Fda, Aa^Fda, Aa^Fda, Aa^Esa, Aa, Aa^Eff, Rb, Re, Aa, Aa^Esa, Aa^Vha, Re, Gg, Aa, Gs, Aa, Re^Es, Gs, Aa, Aa^Esa, Aa^Fdw, Aa, Gg^Fdw, Ww, Ww, Wo, Ww, Ww, Wwf, Gg^Qhh, Hh, Gg, Gg, Aa, Aa
Gg, Gg^Fds, Gs^Fdw, Aa^Fda, Aa, Aa^Esa, Aa, Aa, Gg, Re^Edt, Gs^Fdw, Ce^Edt, Gs, Gs^Fdw, Gs^Fdw, Gs^Fdw, Aa^Qhh, Re^Es, Ds^Esd, Re, Re, Re^Es, Ww, Gg, Ww, Ww, Ai, Ww, Ww, Ww, Wwf, Gs^Qhh, Gs, Gg, Gs, Gs, Re
Re^Eff, Gg, Gg, Aa, Aa, Aa, Gg^Qhh, Gg^Qhh, Gg^Qhh, Gg, Gg, Gs^Fdw, Gg^Qhh, Gs^Fdw, Gs^Qhh, Aa^Qhh, Aa^Esa, Aa^Qhh, Ds^Esd, Ds, Ch, Re, Ww^Bw\, Ai, Ai, Ww, Ai, Ww, Ww, Ww, Ww, Wwf, Gs, Gs, Re, Re, Re
Re^Es, Re^Eff, Re^Eff, Gg, Re^Eff, Rb^Eff, Rb, Rb, Aa, Aa^Qhh, Aa^Qhh, Gg^Qhh, Rb, Gg^Qhh, Gg^Qhh, Gg, Aa^Qhh, Aa^Qhh, Ai, Ai, Ai, Ai, Ai, Ai, Ai, Ai, Ai, Ww, Ww, Ww, Wwf, Wwf, Rb, Gs, Re, Re^Vh, Re^Es
Re, Re^Wm, Re, Re^Eff, Re^Eff, Re, Rb, Rb, Aa, Aa, Aa, Aa, Re, Rb, Rb, Aa^Esa, Aa^Qhh, Ai, Ww, Ai, Ai, Ww, Ai, Ai, Ai, Ai, Ww, Ww, Aa, Aa, Rb, Rb^Vh, Re, Re, Re, Re^Es, Re^Es
Aa, Re, Re, Re^Es, Re^Es, Rb^Eff, Gg^Vhr, Rb, Aa, Aa^Esa, Aa^Esa, Aa^Esa, Re, Rb, Gg^_mh, Gg^Qhh, Ww, Ww, Ww, Ai, Ai, Ai, Ai, Ai, Ww, Wo, Ai, Ai, Ds, Aa, Aa^Esa, Aa, Re, Re, Re, Re, Re^Eff
Aa, Re, Aa, Re^Es, Re, Re, Gg, Gg, Rb, Aa, Aa, Re, Aa, Aa, Aa^Qhh, Gg^Qhh, Ww, Ww, Ww, Ai, Ai, Ai, Ai, Ai, Ww, Ww, Aa, Aa, Ds, Aa^Eff, Rb^Eff, Aa, Re, Re^Es, Re^Eff, Re^Eff, Re
Rb, Aa, Rb^Eff, Rb, Gg, Gg, Hh, Hh, Hh, Rb, Aa, Aa, Re^Qhh, Re^Qhh, Ww, Ww, Ww, Ww, Ww, Ww, Ww, Ww, Ww, Ww, Ww, Ww, Ai, Gs, Gg, Gg, Gg, Rb^Eff, Rb^Eff, Re^Eff, Re, Re, Re
Re^Eff, Rb^Eff, Rb^Eff, Gg^Vhr, Gg, Gg, Gg, Hh, Hh, Hh, Hh^Qhh, Rb^Qhh, Ai, Ai, Ww, Ww, Ai, Ai, Ww, Ww, Ww, Ww, Ai, Ai, Ai, Ai, Ai, Ds, Dd, Aa, Gg^Eff, Gg^Eff, Rb, Rb, Aa, Re, Aa^Esa
Re, Rb, Re, Rb^Eff, Re^Eff, Gg, Gg, Hh, Hh, Hh, Hh^Qhh, Aa, Ai, Ww, Wo, Wo, Ai, Ai, Ww, Ww, Aa, Aa, Dd, Aa, Aa, Ai, Aa, Dd, Aa, Aa^Eff, Gs^Eff, Rb, Rb, Aa, Rb, Aa^Esa, Aa^Esa
Aa, Re, Re, Re, Re, Re, Aa, Gg, Aa, Hh^Qhh, Ha, Aa, Ww, Ww, Ai, Ai, Ww, Ai, Ww, Ww, Aa^Esa, Aa, Aa, Aa, Aa^Esa, Aa^Esa, Aa, Aa, Aa^Esa, Aa, Aa, Aa^Eff, Aa^Eff, Rb, Rb, Aa, Rb
Re, Aa, Aa, Aa, Aa, Aa^Esa, Aa^Esa, Aa, Aa, Hh^Qhh, Aa, Ww, Ww, Ai, Ai, Ai, Ai, Ai, Dd, Dd, Dd, Aa, Ds, Ds, Aa, Aa, Aa, Aa, Ha, Gs, Gg, Aa, Aa, Aa^Eff, Aa, Aa, Rb
Aa, Rb, Rb, Aa, Aa, Aa, Aa, Aa, Gg^Qhh, Aa^Qhh, Ww, Ww, Ai, Ai, Wo, Ww, Ww, Ai, Aa, Aa, Gd, Aa, Ha, Ha, Aa, Ha^Esa, Ha^Esa, Gs, Ha, Ha, Aa, Aa, Gs, Aa, Gs, Aa, Aa
Aa, Aa, Aa, Aa, Aa, Aa, Aa, Aa, Aa^Qhh, Ww, Ww, Wo, Wo, Ai, Ai, Ww, Ai, Aa, Dd, Aa, Dd, Dd, Aa, Ha^Esa, Aa^Esa, Aa, Aa, Ha, Aa, Gs, Aa, Aa, Ha, Gs, Ha^Esa, Ha, Aa^Esa
Aa^Esa, Aa, Aa, Aa, Aa, Aa, Aa^Esa, Aa^Qhh, Ai, Ww, Ww, Wo, Wo, Ai, Ww, Ai, Dd, Dd, Dd, Dd, Ds, Aa, Aa^Esa, Aa^Esa, Aa, Aa, Aa, Aa, Aa, Ha^Esa, Aa, Aa, Aa, Ha^Esa, Ha^Esa, Aa^Esa, Aa^Esa
Aa, Aa^Esa, Aa, Aa, Aa, Aa^Esa, Gg^Qhh, Ai, Ww, Ww, Wo, Wo, Wo, Ww, Ww, Ai, Dd, Aa, Ds, Ds, Aa, Aa, Aa, Aa, Aa, Gs, Gs, Gs, Hh, Ha, Gs, Ha, Aa, Aa, Gs, Ha^Esa, Gs^Esa
