Gs^Eff, Gs^Eff, Gs^Fmw, Re, Re^Edt, Ai, Ai, Ww, Ww, Ww, Ww, Aa^Qhh, Aa^Qhh, Aa^Qhh, Rb^Qhh
Rb, Rb, Rb, Gs^Edt, Re, Ai, Cha^Edt, Ai, Wo, Wo, Wo, Ww, Ww, Ch^Qhh, Rr^Qhh
Aa^Esa, Rb, Rb, Re, Gd^Vh, Aa^Fma, Aa^Fda, Aa, Rr^Vct, Wo, Wo, Ww, Ww^Bw/, Rr^Qhh, Gs^Qhh
Aa, Aa, Rb, Re, Re, Aa^Fdw, Rp, Ch, Rp^Dr, Ch, Rr, Ww^Bw/, Ww, Ww, Ww
Aa^Esa, Rb, Re^Dr, Aa^Dr, Re, Rp, Rp, Rr^Dr, Aa^Esa, Rr, Aa^Vhca, Rr, Wo, Wo, Ai
Re^Es, Re, Gs, Re, Re, Rr, Isa^Eb, Aa^Esa, Aa^Esa, Aa, Cha^Dr, Cha, 2 Kha, Wo, Wo
Re^Eff, Re, Aa, Aa^Edt, Aa, Re^Edt, Rr, Rr, Aa, Rr, Isa^Eb, Ch^Xo, Ch, Wo^Bw\, Wo
Gs^Eff, Gs^Eff, Aa, Aa, Re, Re, Aa, Aa, Aa^Dr, Aa^Esa, Aa^Edt, Aa, Aa^Edt, Ww^Dr, Wo
Gs, Aa, Gs^Edt, Gs, Re, Aa^Esa, Aa^Fda, Aa^Fda, Rr, Rp, Aa^Vhca, Aa^Dr, Ww, Ww, Ww
Gs, Gd^Edt, Gs, Gd^Edt, Rr, Re, Aa, Aa^Fda, Re, Gs^Fdw, Re^Dr, Aa^Fda, Ww, Ww, Ai
Re, Gs^Edt, Re^Edt, Rr, Rr, Isa^Eb, Rp^Edt, Rp^Edt, Re, Aa^Es, Aa^Edt, Aa^Dr, Aa, Ww, Ai
Aa, Re, Re, Cha^Dr, Aa^Vhca, Rp^Edt, Ch, Rp, Aa, Re^Es, Aa, Gs^Fdw, Aa^Fda, Wwr, Ai
