Xos, Xos, Xos, Xos, Xos, Xos, Xos, Xos, Xos, Xos, Xos, Xos, Xos, Xos, Xos, Xos, Xos, Xos, Xos, Xos, Xos, Xos
Isr^_s, Xos, Xos, Xos, Xos, Xos, Xos, Xos, Xos, Xos, Xos, Xos, Xos, Xos, Xos, Xos, Xos, Xos, Xos, Xos, Xos, Isr^_s
Isr^_s, Xos, Xos, Xos, Xos, Xos, Xos, Xos, Xos, Xos, Xos, Xos, Xos, Xos, Xos, Xos, Xos, Xos, Xos, Xos, Xos, Isr^_s
Isr^_s, Xos, Xos, Xos, Xos, Xos, Xos, Xos, Xos, Xos, Xos, Xos, Xos, Xos, Xos, Xos, Xos, Xos, Xos, Xos, Xos, Isr^_s
Isr^_s, Xos, Xos, Xos, Xos, Xos, Xos, Xos, Xos, Xos, Xos, Xoc^Efs, Ch, Xos^Efs, Xos, Xos, Xos, Xos, Xos, Xos, Xos, Isr^_s
Isr^_s, Xos, Xos, Xos, Xos, Xos, Xos, Xos, Xoc, Xos, Ch, Ch, Isr, Ch, Ch, Xos^Efs, Xos, Xos, Xos, Xos, Xos, Isr^_s
Isr^_s, Xos, Xos, Xos, Xos, Xoc, Xoc^Exw, Xoc^Exw, Iwr^Eb, Ch, Isa, Isa, 2 Isr, Isr, Isa, Ch, Xos, Xos, Xos, Xos, Xos, Isr^_s
Xos, Xos, Xos, Xos, Xoc^Exw, Xoc, Iwc, Iwc, Iwr, Iwc, Iwc, Isr, Isr, Isr, Isr, Ch, Xos, Xos, Xos, Xos, Xos, Isr^_s
Isr^_s, Xos, Xos, Xoc^Exw, Iwr^Eb, Iwc, Iwr, Iwo, Iwo, Iwo^Efs, Iwo, Iwc, Iwc, Isr, Isr, Ch, Xos, Xos, Xos, Xos, Xos, Xoc^_s
Isr^_s, Xos, Xoi^Exw, Xos, Ch, Iwr, Iwr, Iwo, Iwo, Iwo, Iwo, Iwr, Iwo^Efs, Iwc, Iwr^Eb, Ch, Xos, Xos, Xos, Xos, Xos, Isr^_s
Iwr^_s, Xos, Xos, Xos, Iwr, Iwr, Ch, Iwr, Iwr, 1 Iwo, Iwr, Iwr, Iwr, Iwo, Iwo, Xos, Xos, Xos, Xos, Xos, Iwr, Iwr^_s
Iwr^_s, Iwr, Iwr, Iwr, Xos, Xos, Xos, Iwr, Iwr, Iwo, Iwr, Iwo, Iwo, Ch, Xos, Iwr, Iwr, Xos, Iwr, Iwr, Iwr, Iwr^_s
Iwr^_s, Xos, Xos, Xos, Xos, Xos, Xos, Xos, Xos, Iwr, Iwr, Iwo, Iwr^Pw/o, Xos, Xos, Xos, Xos, Iwr, Xos, Xos, Xos, Iwr^_s
Iwr^_s, Xos, Xos, Xos, Xos, Xos, Xos, Xos, Xos, Xos, Xos, Iwr^Pw/o, Iwo, Iwr, Iwr, Xos, Xos, Xos, Xos, Xos, Xos, Isr^_s
Iwr^_s, Xos, Xos, Xos, Xos, Xos, Xos, Xos, Xos, Xos, Iwr, Iwr, Iwo, Iwr, Iwr, Ch, Ch^Ebn, Xos, Xos, Xos, Xoi, Isr^_s
Iwr^_s, Xos, Xos, Xos, Xos, Xos, Xos, Xos, Xos, Xos, Iwr, Iwo, Iwo, Iwr, Iwo, Iwr, Iwr, Xos, Xos, Xos, Xoi, Isr^_s
Iwr^_s, Xos, Xoi, Xos, Xos, Xos, Xos, Xos, Xos, Xos, Xos, Iwr, Iwr, Iwr, Iwr, Iwr, Iwr, Xos, Xos, Xos, Xos, Iwr^_s
