Aa^Qhu, Aa^Qhu, Aa^Qhu, Aa^Qhu, Aa^Qhu, Aa^Qhu, Aa^Qhu, Aa^Qhu, Aa^Qhu, Gs^Qhu, Gd, Gs, Rb, Rb, Gs^Es, Gs, Aa, Aa, Aa, Aa, Aa, Aa, Aa^Qhu, Aa^Qhu, Aa^Qhu, Gd^Qhu, Aa^Qhu, Aa^Qhu, Aa^Qhu, Aa^Qhu, Aa^Qhu, Aa^Qhu
Aa^Qhu, Aa^Esa, Aa^_ml, Aa, Rb, Aa^Esa, Rb^Qhu, Aa^Qhu, Gs, Gd^Em, Gd, Gs, Rb, Gs^Es, 1 Gs^Es, Aa, Gs^Eff, Aa, Gs, Gs^Vh, Aa, Aa^Esa, Aa, Aa^Qhu, Aa, Aa, Aa, Aa, Aa, Aa^Qhu, Aa^Qhu, Aa^Qhu
Aa^Qhu, Aa, Rb^Qhu, Re^Qhu, Re^Qhu, Rb^Qhu, Rb, Re^Edt, Aa^Eff, Gs, Gs^Es, Rb, Gd^Edt, Gd, Rb^Gvs, Re^Eff, Rb^Gvs, Gs^Eff, Gs^Eff, Aa, Aa, Aa, Gs, Gs, Gs, Gd^Vh, Gd, Ce, Ce, Aa, Aa^Qhu, Aa^Qhu
Rb^Qhu, Aa^Qhu, Rb, Aa, Rb, Re, Re^Edt, Re^Edt, Aa^Eff, Aa^Eff, Rb, Gd, Gd^Qhh, Gs, Aa, Rb^Gvs, Rb^Gvs, Rb^Gvs, Rb^Gvs, Gs^Eff, Gs^Eff, Aa, Re^Gvs, Gd, Aa, Aa, Aa, Ce, Gs, Aa, Aa, Aa^Qhu
Rb, Rb, Aa, Rb, Aa, Rb, Gs^Vh, Gs^Eff, Gs^Edt, Aa^Esa, Rb, Gd^Qhh, Rr^Vhc, Aa^Qhh, Aa^Qhh, Rb^Gvs, Rb^Gvs, Rb^Gvs, Rb^Gvs, Rb^Gvs, Rb, Re, Re^Gvs, Rb^Gvs, Re^Gvs, Aa, Gd, Gd, Gs, Gs, Aa, Aa^Qhu
Re, Rb, Aa, Aa, Aa^Edt, Ce^Edt, Rp^Ebn, Gs, Rp, Rb, Rb^Edt, Ch^Qhh, Kh^_mh, Aa^Edt, Aa, Rb^Qhh, Rb^Gvs, Rb^Qhh, Rb^Qhh, Rb^Qhh, Rb^Qhh, Rb^Gvs, Rb^Gvs, Rb^Gvs, Rb^Gvs, Rb^Gvs, Rb, Gd^Es, Gs, Gs, Rb^Gvs, Rb
Aa, Gd, Aa, Aa, Ce, Ce^Edt, Rb^Edt, Rb^Es, Rb, Gs^Ebn, Rr^Vhc, Ch^Qhh, Ch^Qhh, Ch^Qhh, Ch^Qhh, Aa^Edt, Rb^Gvs, Rb^Gvs, Aa, Rb^Gvs, Aa, Rb^Qhh, Rb^Qhh, Rb^Gvs, Rb^Gvs, Rb^Gvs, Gs^Eff, Gs, Re, Re^Gvs, Re^Gvs, Re^Gvs
Ai, Aa^Esa, Aa^Esa, Ce, Ai, Gs^Vh, Gs^Es, Rb^Vh, Rp, Rb, Wwg, Ai, Ai, Ai, Ai, Gs^Qhh, Gd^Qhh, Aa^Qhh, Aa^Qhh, Aa^Qhh, Gd^Qhh, Re^Gvs, Rb^Gvs, Rb^Qhh, Gd, Gs^Eff, Gs^Eff, Rb^Gvs, Rb^Gvs, Rb^Gvs, Rb^Gvs, Re^Gvs
Wwg, Ai, Wwg, Wwg, Wwg, Wwg, Wwg, Rp^Edt, Wwg^Bw\, Wwg, Ai, Ai, Wwg, Ai, Ai, Ai, Wwg, Ai, Ai, Ai, Ai, Gd^Qhh, Gd^Qhh, Gs^Qhh, Gs^Vh, Gd^Eff, Gs, Gs^Wm, Rb^Gvs, Rb^Gvs, Rb^Gvs, Aa
Wwg, Wog, Wog, Wog, Wog, Wog, Wog, Wwg, Wog, Wwg^Bw\, Gs, Ai, Gs, Wwg, Wwg, Wog, Wog, Wog, Wog, Ai, Wog, Wwg, Ai, Ai, Ai, Gd, Gd, Rb^Es, Aa, Aa, Aa, Aa
Gs, Wwg, Wwg, Wwg, Wwg, Wog, Wwg, Wog, Ai, Ai, Rb^Vh, Gs, Gd, Rb^Vh, Gd, Wwg, Wwg, Wwg, Wwg, Wwg, Wog, Wog, Wog, Wwg, Wwg, Ai, Wwg, Gd, Gs, Aa^Esa, Aa, Aa
Gs, Gs, Gs, Gs, Gs, Wwg, Gs, Wwg, Gs, Gs, Gd, Gd, Ce, Ce, Gd, Gd, Gd, Gs, Gs, Gs, Gs, Wwg, Wwg, Wwg, Wwg, Wog, Wog, Wwg, Wog, Wwg, Ai, Rb
Gs, Gs, Gs, Gs, Gs, Gs, Gs^Es, Gs, Gs, Gs, Gs, Gs, Gs, Gd, Gd, Gs, Gs, Gs, Gs, Gs, Gs, 2 Gs, Gs, Gs, Gs, Wwg, Ai, Wog, Ai, Wog, Wog, Ai
Gs, Gs, Gs, Gs, Gs, Gs, Gs, Gs, 3 Gs, Gs, Gs, Gs, Gs, Gs, Gs, Gs, Gs, Gs, Gs, Gs, Gs, Gs, Gs, Gs, Gs, Gs, Gs, Ai, Ai, Wwg, Ai, Wog
Gs, Gs, Gs, Gs, Gs, Gs, Gs, Gs, Gs, Gs, Gs, Gs, Gs, Gs, Gs, Gs, Gs, Gs, Gs, Gs, Gs, Gs, Gs, Gs, Gs, Gs, Gs, Gs, Gs, Wwg, Gs, Wwg
Gs, Gs, Gs, Gs, Gs, Gs, Gs, Gs, Gs, Gs, Gs, Gs, Gs, Gs, Gs, Gs, Gs, Gs, Gs, Gs, Gs, Gs, Gs, Gs, Gs, Gs, Gs, Gs, Gs, Gs, Gs, Gs
Gs, Gs, Gs, Gs, Gs, Gs, Gs, Gs, Gs, Gs, Gs, Gs, Gs, Gs, Gs, Gs, Gs, Gs, Gs, Gs, Gs, Gs, Gs, Gs, Gs, Gs, Gs, Gs, Gs, Gs, Gs, Gs
Gs, Gs, Gs, Gs, Gs, Gs, Gs, Gs, Gs, Gs, Gs, Gs, Gs, Gs, Gs, Gs, Gs, Gs, Gs, Gs, Gs, Gs, Gs, Gs, Gs, Gs, Gs, Gs, Gs, Gs, Gs, Gs
Gs, Gs, Gs, Gs, Gs, Gs, Gs, Gs, Gs, Gs, Gs, Gs, Gs, Gs, Gs, Gs, Gs, Gs, Gs, Gs, Gs, Gs, Gs, Gs, Gs, Gs, Gs, Gs, Gs, Gs, Gs, Gs
Gs, Gs, Gs, Gs, Gs, Gs, Gs, Gs, Gs, Gs, Gs, Gs, Gs, Gs, Gs, Gs, Gs, Gs, Gs, Gs, Gs, Gs, Gs, Gs, Gs, Gs, Gs, Gs, Gs, Gs, Gs, Gs
Gg, Gg, Gg, Gg, Gg, Gg, Gg, Gg, Gg, Gg, Gg, Gg, Gg, Gg, Gg, Gg, Gg, Gg, Gg, Gg, Gg, Gg, Gg, Gg, Gg, Gg, Gg, Gg, Gg, Gg, Gg, Gg
Gg, Gg, Gg, Gg, Gg, Gg, Gg, Gg, Gg, Gg, Gg, Gg, Gg, Gg, Gg, Gg, Gg, Gg, Gg, Gg, Gg, Gg, Gg, Gg, Gg, Gg, Gg, Gg, Gg, Gg, Gg, Gg
Gg, Gg, Gg, Gg, Gg, Gg, Gg, Gg, Gg, Gg, Gg, Gg, Gg, Gg, Gg, Gg, Gg, Gg, Gg, Gg, Gg, Gg, Gg, Gg, Gg, Gg, Gg, Gg, Gg, Gg, Gg, Gg
Gg, Gg, Gg, Gg, Gg, Gg, Gg, Gg, Gg, Gg, Gg, Gg, Gg, Gg, Gg, Gg, Gg, Gg, Gg, Gg, Gg, Gg, Gg, Gg, Gg, Gg, Gg, Gg, Gg, Gg, Gg, Gg
Gg, Gg, Gg, Gg, Gg, Gg, Gg, Gg, Gg, Gg, Gg, Gg, Gg, Gg, Gg, Gg, Gg, Gg, Gg, Gg, Gg, Gg, Gg, Gg, Gg, Gg, Gg, Gg, Gg, Gg, Gg, Gg
Gg, Gg, Gg, Gg, Gg, Gg, Gg, Gg, Gg, Gg, Gg, Gg, Gg, Gg, Gg, Gg, Gg, Gg, Gg, Gg, Gg, Gg, Gg, Gg, Gg, Gg, Gg, Gg, Gg, Gg, Gg, Gg
Gg, Gg, Gg, Gg, Gg, Gg, Gg, Gg, Gg, Gg, Gg, Gg, Gg, Gg, Gg, Gg, Gg, Gg, Gg, Gg, Gg, Gg, Gg, Gg, Gg, Gg, Gg, Gg, Gg, Gg, Gg, Gg
Gg, Gg, Gg, Gg, Gg, Gg, Gg, Gg, Gg, Gg, Gg, Gg, Gg, Gg, Gg, Gg, Gg, Gg, Gg, Gg, Gg, Gg, Gg, Gg, Gg, Gg, Gg, Gg, Gg, Gg, Gg, Gg
Gg, Gg, Gg, Gg, Gg, Gg, Gg, Gg, Gg, Gg, Gg, Gg, Gg, Gg, Gg, Gg, Gg, Gg, Gg, Gg, Gg, Gg, Gg, Gg, Gg, Gg, Gg, Gg, Gg, Gg, Gg, Gg
Gg, Gg, Gg, Gg, Gg, Gg, Gg, Gg, Gg, Gg, Gg, Gg, Gg, Gg, Gg, Gg, Gg, Gg, Gg, Gg, Gg, Gg, Gg, Gg, Gg, Gg, Gg, Gg, Gg, Gg, Gg, Gg
Gg, Gg, Gg, Gg, Gg, Gg, Gg, Gg, Gg, Gg, Gg, Gg, Gg, Gg, Gg, Gg, Gg, Gg, Gg, Gg, Gg, Gg, Gg, Gg, Gg, Gg, Gg, Gg, Gg, Gg, Gg, Gg
Gg, Gg, Gg, Gg, Gg, Gg, Gg, Gg, Gg, Gg, Gg, Gg, Gg, Gg, Gg, Gg, Gg, Gg, Gg, Gg, Gg, Gg, Gg, Gg, Gg, Gg, Gg, Gg, Gg, Gg, Gg, Gg
Gg, Gg, Gg, Gg, Gg, Gg, Gg, Gg, Gg, Gg, Gg, Gg, Gg, Gg, Gg, Gg, Gg, Gg, Gg, Gg, Gg, Gg, Gg, Gg, Gg, Gg, Gg, Gg, Gg, Gg, Gg, Gg
Gg, Gg, Gg, Gg, Gg, Gg, Gg, Gg, Gg, Gg, Gg, Gg, Gg, Gg, Gg, Gg, Gg, Gg, Gg, Gg, Gg, Gg, Gg, Gg, Gg, Gg, Gg, Gg, Gg, Gg, Gg, Gg
Gg, Gg, Gg, Gg, Gg, Gg, Gg, Gg, Gg, Gg, Gg, Gg, Gg, Gg, Gg, Gg, Gg, Gg, Gg, Gg, Gg, Gg, Gg, Gg, Gg, Gg, Gg, Gg, Gg, Gg, Gg, Gg
Gg, Gg, Gg, Gg, Gg, Gg, Gg, Gg, Gg, Gg, Gg, Gg, Gg, Gg, Gg, Gg, Gg, Gg, Gg, Gg, Gg, Gg, Gg, Gg, Gg, Gg, Gg, Gg, Gg, Gg, Gg, Gg
Gg, Gg, Gg, Gg, Gg, Gg, Gg, Gg, Gg, Gg, Gg, Gg, Gg, Gg, Gg, Gg, Gg, Gg, Gg, Gg, Gg, Gg, Gg, Gg, Gg, Gg, Gg, Gg, Gg, Gg, Gg, Gg
Gg, Gg, Gg, Gg, Gg, Gg, Gg, Gg, Gg, Gg, Gg, Gg, Gg, Gg, Gg, Gg, Gg, Gg, Gg, Gg, Gg, Gg, Gg, Gg, Gg, Gg, Gg, Gg, Gg, Gg, Gg, Gg
Gg, Gg, Gg, Gg, Gg, Gg, Gg, Gg, Gg, Gg, Gg, Gg, Gg, Gg, Gg, Gg, Gg, Gg, Gg, Gg, Gg, Gg, Gg, Gg, Gg, Gg, Gg, Gg, Gg, Gg, Gg, Gg
Gg, Gg, Gg, Gg, Gg, Gg, Gg, Gg, Gg, Gg, Gg, Gg, Gg, Gg, Gg, Gg, Gg, Gg, Gg, Gg, Gg, Gg, Gg, Gg, Gg, Gg, Gg, Gg, Gg, Gg, Gg, Gg
