Gg, Gg, Gg, Re^Gvs, Rb^Gvs, Re, Re^Gvs, Re, Re^Gvs, Re^Gvs, Re^Gvs, Re, Re^Gvs, Rb^Gvs, Rb^Gvs, Gg, Gg, Re, Re, Gs, Gd^Fdw, Gs^Fmw, Gd^Es, Ww, Ww, Ww, Ww, Ww, Re^Qhh, Gs^Qhh, Re^Qhh, Re^Qhh, Rb^Eff, Re^Qhh, Gg^Qhh, Gs^Qhh, Gg^Fms, Rr^Es, Gg, Gs^Fds, Gs^Fds
Gs^Fds, Gg, Gg, Gg, Gg, Re, Re, Re^Gvs, Re^Gvs, Re^Gvs, Re^Gvs, Rb^Gvs, Rb^Gvs, Rb^Gvs, Rb, Rb^Gvs, Gg, Gd, Gd, Re^Es, Gd, Ce, Ww, Ww, Wo, Ww, Gg^Qhh, Gs^Qhh, Re^Gvs, Re^Gvs, Re^Gvs, Re^Gvs, Re^Gvs, Rb^Eff, Re^Eff, Gg, Gg, Gg, Gg, Gs^Fms, Gg
Gg, Gs^Fds, Gs^Fms, Gs^Fds, Gs^Fds, Gg, Gg, Re^Gvs, Rb^Gvs, Re^Gvs, Rb^Gvs, Rb^Gvs, Rb, Rb, Gg, Gg, Gg, Ce, Gd, Re, Gs, Gs^Vh, Ww, Wo, Ww, Ww, Re^Qhh, Gs^_mh, Re^Gvs, Rb^Gvs, Rb^Gvs, Rb^Gvs, Rb^Gvs, Re^Gvs, Re^Gvs, Gs^Eff, Gs^Wm, Gg, Re, Gg, Re
Gs^Fds, Gs^Fms, Gg, Gs^Fms, Gs^Fds, Gg, Gs^Fms, Gg, Gg, Rb^Gvs, Gg, Gg, Gs^Eff, Gs^Eff, Gd^Eff, Gs, Gs^Eff, Gs^Eff, Gs^Fds, Re, Re, Ww, Ww, Wo, Ww, Ww, Ww, Re^Qhh, Re^Qhh, Re^Gvs, Rb^Gvs, Rb^Gvs, Rb^Gvs, Re^Gvs, Gs, Gs, Re^Es, Re, Gs^Fds, Re, Gs^Fds
Gs^Fms, Gs^Fds, Gs^Fds, Gs^Fms, Gs^Fds, Gs^Fds, Gg, Gs^Fms, Gg, Gg, Ce, Gs, Re^Gvs, Re^Gvs, Re^Gvs, Gd, Rb^Gvs, Rb^Gvs, Rb^Gvs, Re, Re, Ww, Ch, Ww, Ww, Ww, Ww, Ww, Ww, Ch^Qhh, Rr^Es, Rb^Gvs, Re, Gs, Re, Re, Gs, Gs^Es, Gs^Fms, Gs^Fms, Gs^Fms
Gg^Fms, Gs^Fms, Gs^Fds, Gg, Gs^Fds, Gg, Gg, Gg, Gg, Gg, Rb^Gvs, Re^Gvs, Re^Gvs, Re^Gvs, Re^Gvs, Rb^Gvs, Rb^Gvs, Rb^Gvs, Rb^Gvs, Gs, Re, Re, Ch, Rr, Rp, Ww^Ewf, Ww^Ewl, Ww, Ww^Bw/, Rr^Qhh, Gs^Qhh, Rr, Gg, Re, Gg^Fms, Gs^Fds, Gs^Fds, Gs^Fds, Gs^Fds, Gs^Fds, Gs^Fds
Gg, Gs^Fds, Gs^Fds, Gg, Gg, Gg^Fms, Gg, Gg, Rb^Gvs, Rb^Gvs, Rb^Gvs, Re^Gvs, Re^Gvs, Re^Gvs, Re^Gvs, Rb^Gvs, Rb^Gvs, Rb^Gvs, Rb^Gvs, Gs, Rr^Vh, Re^Es, Rp, Ch, Ch, Ch, Rr, Ww^Bw/, Ww, Ww, Ww, Ch^Qhh, Gg^Qhh, Gg, Gg, Gg^Fms, Gg^Fds, Gg^Fds, Gs^Fds, Gs^Fds, Gs^Fds
Gg, Gs^Fds, Gs^Fms, Gg, Gg, Gg, Gg, Rb^Gvs, Rb^Gvs, Rb^Gvs, Rb^Gvs, Re^Gvs, Re^Gvs, Re^Gvs, Re^Gvs, Re^Gvs, Re^Gvs, Rb^Gvs, Re, Re, Ch, Rp, Rp, Rr, Rr^Es, Rr, Ch, Rr^Vhc, Ww^Ewl, Wo, Wo, Ww, Ww, Gg^Qhh, Gg^Qhhf, Gs^Fds, Gs^Vl, Gg^Fms, Gs^Fds, Gs^Fms, Hh^Fms
Rb^Gvs, Gg, Gs^Fms, Gs^Fms, Gg, Gg, Gg, Rb, Rb, Rb^Gvs, Rb^Gvs, Re^Gvs, Re^Vh, Re^Gvs, Re^Gvs, Re^Gvs, Re, Re, Gs, Re, Ch, Rr, Rp, Rr, Rr^Es, Rr^Vhc, Ch^Ebn, Ch, 2 Kh, Wo, Wo, Wo, Ww, Ww, Gg^Qhh, Gg, Gs^Fds, Gg^Fms, Hh, Hh^Fms, Hh^Fms
Rb^Gvs, Rb^Gvs, Rb^Gvs, Gg, Gg, Gg, Gg, Gg, Gg, Rb, Ce, Rb, Re^Gvs, Re^Gvs, Rb^Wm, Rb, Re^Eff, Re, Gs, Gs, Re, Ch, Rr, Rr, Rr, Rr, Rr, Rr, Ch, Ww^Bw/, Wo, Wo, Wo, Ww, Gg^Qhhf, Gs^Fms, Hh^Fms, Gg, Gg, Hh^Fms, Gg
Rb^Gvs, Rb^Gvs, Rb^Gvs, Rb^Gvs, Rb^Gvs, Gg, Gg, Gg, Gg, Gs, Ce, Re^Gvs, Re^Gvs, Re^Gvs, Re^Gvs, Rb^Gvs, Gs^Eff, Gs^Eff, Gs, Gs, Gs^Vh, Re, Re, Rr, Rr^Vhc, Rp, Rp, Ch^Ebn, Ch, Ww^Bw/, Wo, Wo, Ww, Ds, Hd, Gg^Qhh, Gg, Gg, Hh^Fms, Hh, Hh
Re^Gvs, Re^Gvs, Re^Gvs, Rb^Gvs, Rb^Gvs, Rb^Gvs, Rb^Gvs, Gs^Fms, Gs^Fms, Gs, Ce, Re, Gs^Vh, Re^Gvs, Gd^Eff, Gs^Eff, Gs, Gs, Gs, Gs, Re, Re, Re, Ch, Rr, Rp, Rr^Vhc, Rr^Vhc, Ww^Ewf, Ww^Ewl, Ww, Ww, Ds, Hd, Rd^Qhh, Gd^Qhh, Gg, Gg, Gg, Gg, Hh
Re^Gvs, Re^Gvs, Re^Gvs, Rb^Gvs, Rb^Gvs, Rb^Gvs, Re^Gvs, Gs^Fds, Gs^Fds, Re^Es, Re, Ce, Gd, Gs, Gd, Gd, Gs, Gd, Gs, Gd, Re, Re, Gs, Gs, Re, Ch, Ch, Ch, Ww, Ww, Wo, Ww, Wwr, Gg^Qhh, Gg, Gg, Hh, Gg^Qhh, Gg, Hh, Hh
Re^Gvs, Re^Gvs, Re^Gvs, Rb^Gvs, Rb^Gvs, Rb^Gvs, Re^Gvs, Re^Gvs, Re, Re, Re, Gg, Re, Rb, Gs, Gd, Re, Gs, Re, Re, Rr^Vhc, Re^Es, Rp, Gs, Re, Re^Es, Re, Re, Gs, Ww, Wo, Wo, Wo, Rd^Qhh, Gg^Qhh, Hh, Hh, Gg, Gg, Gg, Gg
Re^Gvs, Re^Gvs, Gg, Rb^Gvs, Rb^Gvs, Re^Gvs, Gs^Fms, Gs^Fms, Gs^Fms, Gg, Gg, Re^Es, Gg^Eff, Re^Eff, Rb^Gvs, Re^Gvs, Re^Gvs, Re, Re, Ch, Rr, Rp^Vhc, Rp, Gs, Re, Re^Es, Re, Gg^Fms, Gg^Fds, Wwr, Gg^Fds, Wo, Wo, Ww, Gg^Qhh, Gg, Hh, Hh, Gg, Gg, Gg
Gg, Gg, Gg, Gg, Gg, Gg, Gs^Fms, Gs^Fms, Gg, Gg, Gg^Eff, Gg^Eff, Rb^Gvs, Rb^Gvs, Rb^Gvs, Re^Gvs, Re^Gvs, Re, Gg^Fms, Ch, Ch, Rp, Ch, Re, Re, Gs, Gs, Re, Gs^Vh, Gg^Fms, Wwr, Ww, Wo, Ww, Ww, Gg^Qhh, Gg, Hh, Gg, Gg, Gg
Gs^Fds, Gg, Gg, Gg, Gs^Fms, Gs^Fms, Gs^Fds, Gs^Fds, Gs^Fds, Gg, Gg, Gg^Eff, Rb, Rb^Gvs, Rb^Gvs, Rb^Gvs, Re, Re, Gg, Gg, Gs, Ch, Re^Es, Re, Gs, Gs, Gg^Fms, Gs, Gg^Fds, Ww, Ww, Wo, Ww, Ww, Wwf, Gg^Qhh, Hh, Gg, Gg, Gg, Gg
Gs^Fds, Gg, Gg, Gg, Gg, Gs^Fds, Gs^Fds, Gs^Fds, Gg, Gg, Gg, Gg, Gg, Ce, Gs^Fds, Gs, Gs, Gs^Fds, Gs^Fds, Gs^Qhhf, Gg^Qhh, Re^Es, Gg, Re, Re, Gs, Ww, Gg, Ww, Ww, Wo, Ww, Ww, Ww, Wwf, Gg^Qhh, Gg, Gg, Gg, Gg, Gg
Gs^Fds, Gs^Fds, Gg, Gg, Re^Eff, Gg, Gg, Gg, Gg, Gg, Gg^Qhh, Gg^Qhh, Gg^Qhh, Gg, Gg, Gs^Fms, Gg^Qhh, Gs^Fms, Gs^Qhh, Gg^Qhh, Gg^_mh, Gg^Qhh, Gg^Qhh, Re^Es, Ch, Re, Ww^Bw\, Wo, Wo, Ww, Wo, Ww, Ww, Ww, Ww, Wwf, Gg, Gg, Gg, Gg, Re^Gvs
Gg, Gg, Rb^Eff, Rb^Eff, Re^Gvs, Re^Eff, Re^Eff, Gg, Re^Eff, Rb^Eff, Rb^Gvs, Rb^Gvs, Rb^Gvs, Gg^Qhh, Gg^Qhh, Gg^Qhh, Rb^Gvs, Gg^Qhh, Gg^Qhh, Gg, Gg^Qhh, Gg^Qhh, Ww, Ww, Ww, Ww, Wo, Wo, Wo, Wo, Wo, Ww, Ww, Ww, Wwf, Wwf, Gg, Gg, Re^Gvs, Re^Gvs, Re^Gvs
Rb^Eff, Rb^Eff, Re^Gvs, Re^Gvs, Re^Gvs, Re^Wm, Re^Gvs, Re^Eff, Re^Eff, Re^Gvs, Rb^Gvs, Rb^Gvs, Rb^Gvs, Rb^Gvs, Rb^Gvs, Rb^Gvs, Re^Gvs, Rb^Gvs, Rb, Gg, Gg^Qhh, Ww, Ww, Ww, Wo, Ww, Wo, Wo, Wo, Wo, Ww, Ww, Gg, Gg, Gg, Gg, Re^Gvs, Re^Gvs, Re^Gvs, Re^Gvs, Re^Gvs
Re^Gvs, Re^Gvs, Re^Gvs, Re^Gvs, Re^Gvs, Re^Gvs, Re^Gvs, Re^Gvs, Re^Gvs, Rb^Eff, Gg^Vh, Rb^Gvs, Rb^Gvs, Rb^Gvs, Re^Gvs, Re^Gvs, Re^Gvs, Rb^Gvs, Gg, Gg^Qhh, Ww, Ww, Ww, Wo, Wo, Wo, Wo, Wo, Ww, Wo, Ww^Ewf, Ww, Gg, Gg, Re^Gvs, Re^Gvs, Re^Gvs, Re^Gvs, Re^Gvs, Re^Gvs, Re^Eff
Rb^Gvs, Re^Gvs, Rb^Gvs, Re^Gvs, Re^Gvs, Re^Gvs, Re^Gvs, Re^Gvs, Re^Gvs, Re^Gvs, Gg, Gg, Rb, Rb^Gvs, Re^Gvs, Re^Gvs, Re^Gvs, Gg, Gg^Qhh, Gg^Qhh, Ww, Ww, Ww, Wo, Wo, Wo, Wo, Wo, Ww, Ww, Gg, Gg, Gg, Gg^Eff, Rb^Eff, Re^Gvs, Re^Gvs, Re^Gvs, Re^Eff, Re^Eff, Re^Gvs
Rb^Gvs, Rb^Gvs, Rb^Gvs, Rb^Gvs, Rb^Gvs, Re^Gvs, Rb^Eff, Rb^Gvs, Gg, Gg, Hh, Hh, Hh, Rb^Gvs, Rb^Gvs, Re^Gvs, Re^Qhh, Re^Qhh, Ww, Ww, Ww, Ww, Ww, Ww, Ww, Ww, Ww, Ww, Ww, Ww, Wwf, Gg, Gg, Gg, Gg, Rb^Eff, Rb^Eff, Re^Eff, Re^Gvs, Re^Gvs, Re^Gvs
Re^Gvs, Re^Gvs, Rb^Gvs, Rb^Gvs, Rb^Gvs, Rb^Eff, Rb^Eff, Gg^Vh, Gg, Gg, Gg, Hh, Hh, Hh, Hh^Qhh, Rb^Qhh, Ww, Ww, Ww, Ww, Wo, Wo, Ww, Ww, Ww, Ww, Wwf, Ww, Wwf, Ww, Wwf, Gg, Gg, Gg, Gg^Eff, Gg^Eff, Rb^Gvs, Rb^Gvs, Rb^Gvs, Re^Gvs, Re^Gvs
Re^Gvs, Re^Gvs, Re^Gvs, Re^Gvs, Re^Gvs, Rb^Gvs, Re^Gvs, Rb^Eff, Re^Eff, Gg, Gg, Hh, Hh, Hh, Hh^Qhh, Ds, Ww, Ww, Wo, Wo, Wo, Wo, Ww, Ww, Gg, Gg, Gg, Gg, Gg, Wwf, Gg, Gg, Gg, Gg^Eff, Gg^Eff, Rb^Gvs, Rb^Gvs, Rb^Gvs, Rb^Gvs, Rb^Gvs, Rb^Gvs
Re^Gvs, Re^Gvs, Re^Gvs, Re^Gvs, Re^Gvs, Re^Gvs, Re^Gvs, Re^Gvs, Re^Gvs, Re^Gvs, Re^Gvs, Gg, Gg, Hh^Qhh, Ds, Ds, Ww, Ww, Wo, Wo, Ww, Wo, Ww, Ww, Gg, Gg, Gg, Gg, Gg, Gg, Gg, Gg, Gg, Gg, Gg, Gg^Eff, Rb^Eff, Rb^Gvs, Rb^Gvs, Rb^Gvs, Rb^Gvs
Re^Gvs, Re^Gvs, Re^Gvs, Re^Gvs, Re^Gvs, Re^Gvs, Rb^Gvs, Re^Gvs, Rb^Gvs, Re^Gvs, Re^Gvs, Rb^Gvs, Gg, Hh^Qhh, Ds, Ww, Ww, Wo, Ww, Ww, Ww, Ww, Ww, Gg, Gg, Gg, Gg, Gg, Gg, Gg, Gg, Gg, Gg, Gg, Gg, Gg, Gg, Rb^Eff, Rb^Eff, Rb^Gvs, Rb
