Gg, Gg, Gg^Fms, Gs^Fds, Gs^Fds, Gg^Fds, Rb, Rb^Gvs, Rb^Gvs, Rb, Re^Qhh, Re^Qhh, Re^Qhh, Re^Qhh, Re^Qhh, Re^Qhh, Re^Qhh, Rb^Qhh, Rb^Qhh, Gg^Qhh, Gg^Qhh, Re, Re, Gs, Gd^Fms, Gd^Fms, Gd^Es, Ww, Ww, Ww, Ww, Ww, Re^Qhh, Gs^Qhh, Re^Qhh, Re^Qhh, Rb^Eff, Re^Qhh, Gg^Qhh, Gs^Qhh, Gg^Fms, Rr^Es, Gg, Gs^Fds, Gs^Fds
Gg^Fds, Gg, Gs^Fms, Gg^Fds, Gg^Fds, Gg, Gg, Rb, Rb, Re^Qhh, Re, Re^Gvs, Re^Gvs, Re^Gvs, Re^Gvs, Rb^Gvs, Rb^Gvs, Gs^_mh, Gs^Qhh, Rb^Qhh, Gg, Gd, Gd^Edt, Re^Es, Gd, Ce, Ww, Ww, Wo, Ww, Gg^Qhh, Gs^Qhh, Re^Gvs, Re^Gvs, Re^Gvs, Re^Gvs, Re^Gvs, Rb^Eff, Re^Eff, Gg, Gg, Gg, Gg, Gs^Fms, Gg
Gg, Gg, Gg, Gg, Gg, Gg^Fds, Gg^Fms, Gs^Fds, Gs^Fds, Gg^Qhh, Gg, Re^Gvs, Rb^Gvs, Re^Gvs, Gs^Qhh, Rb^Gvs, Gs^Qhh, Gs^Qhh, Gg, Gg^Es, Gg, Ce, Gd, Re, Gs^Edt, Gs, Ww, Wo, Ww, Ww, Re^Qhh, Gs^_mh, Re^Gvs, Rb^Gvs, Rb^Gvs, Rb^Gvs, Rb^Gvs, Re^Gvs, Re^Gvs, Gs^Eff, Gs^Wm, Gg, Re, Gg, Re
Gs^Fds, Gs^Fds, Gs^Fds, Gs^Fds, Gs^Fds, Gg^Fms, Gg, Gs^Fms, Gs^Fds, Gg^Qhh, Gs^Fms, Gg, Gg^Qhh, Gs^Qhh, Gg, Gg^Qhh, Gs^Eff, Gs^Eff, Gd^Eff, Gs, Gs^Eff, Gs^Eff, Gs^Fds, Re, Re^Edt, Ww, Ww, Wo, Ww, Ww, Ww, Re^Qhh, Re^Qhh, Re^Gvs, Rb^Gvs, Rb^Gvs, Rb^Gvs, Re^Gvs, Gs^Edt, Gs, Re^Es, Re, Gs^Fds, Re, Gs^Fds
Gs^Fms, Gs^Fms, Gs^Fms, Gs^Fms, Gs^Fms, Gs^Fds, Gs^Fds, Gs^Fms, Gs^Fds, Gs^Qhhf, Gg, Gs^Qhhf, Gg, Gg, Ce, Gs, Re^Gvs, Re^Gvs, Re^Gvs, Gd^Eff, Rb^Gvs, Rb^Gvs, Rb^Gvs, Gs^Edt, Re, Ww, Ch, Ww^Ewl, Wo, Wo, Wo, Ww, Ww, Ch^Qhh, Rr^Edt, Rb^Gvs, Re^Edt, Gs, Re, Re, Gs, Gs^Es, Gs^Fms, Gs^Fms, Gs^Fms
Gg^Fms, Gg^Fms, Gg^Fms, Gg^Fms, Gg^Fms, Gs^Fms, Gs^Fds, Gg, Gs^Fds, Gg, Gg^Qhh, Gg^Qhh, Gg, Gg, Rb^Gvs, Re^Gvs, Re^Gvs, Re^Gvs, Re^Gvs, Rb^Gvs, Rb^Gvs, Rb^Gvs, Rb^Gvs, Re, Gd^Vh, Gs^Fdw, Gs^Fdw, Isa^Edt, Rr^Vct, Wo, Wo, Ww, Ww^Bw/, Rr^Qhh, Gs^Qhh, Rr, Gg^Edt, Re, Gg^Fms, Gs^Fds, Gs^Fds, Gs^Fds, Gs^Fds, Gs^Fds, Gs^Fds
Gg, Gg, Gg^Efm, Gg, Gs^Vl, Gs^Fds, Gs^Fds, Gg, Gg, Gg^Fms, Gg, Gg, Rb^Gvs, Rb^Gvs, Rb^Gvs, Re^Gvs, Re^Gvs, Re^Gvs, Re^Gvs, Rb^Gvs, Rb^Gvs, Rb^Gvs, Rb^Gvs, Re, Re, Gs^Fms, Rp, Ch, Ch^Edt, Ch, Rr, Ww^Bw/, Ww, Ww, Ww, Ch^Qhh, Gg^Qhh, Gg, Gg, Gg^Fms, Gg^Fds, Gg^Fds, Gs^Fds, Gs^Fds, Gs^Fds
Gg^Efm, Gg, Gg^Efm, Gg, Gg, Gs^Fds, Gs^Fms, Gg, Gg, Gg, Gg, Ce, Rb^Gvs, Rb^Gvs, Rb^Gvs, Re^Gvs, Re^Gvs, Re^Gvs, Re^Gvs, Re^Gvs, Re^Gvs, Rb^Gvs, Re, Rr^Vh, Re, Rp, Rp, Rr^Edt, Rr^Edt, Rr, Rr^Vhc, Rr, Wo, Wo, Wo, Ww, Ww, Gg^Qhh, Gg^Qhhf, Gs^Fds, Gs^Vl, Gg^Fms, Gs^Fds, Gs^Fms, Hh^Fms
Gg^Efm, Gg^Efm, Gg^Efm, Gg^Efm, Gg, Gg, Gs^Fms, Gs^Fms, Gg, Gg, Gg, Ce, Ce, Rb^Gvs, Rb^Gvs, Re^Gvs, Re^Vh, Re^Gvs, Re^Gvs, Re^Gvs, Re, Re, Gs, Re, Re, Rr, Isa^Ebn, Rr, Rr^Es, Rr^Es, Ch, Ch, 2 Kh, Wo, Wo, Wo, Ww, Ww, Gg^Qhh, Gg, Gs^Fds, Gg^Fms, Hh, Hh^Fms, Hh^Fms
Gg, Gg, Gg, Gg, Rb^Gvs, Rb^Gvs, Rb^Gvs, Gg, Gg, Gg, Gg, Gg, Gg, Ce, Rb, Rb, Re^Gvs, Re^Gvs, Rb^Wm, Rb, Re^Eff, Re, Gs, Gs^Edt, Re^Edt, Rr, Rr, Rr, Rp, Isa, Isa^Ebn, Ch^Xo, Ch, Wo^Bw\, Wo, Wo, Wo, Ww, Gg^Qhhf, Gs^Fms, Hh^Fms, Gg, Gg, Hh^Fms, Gg
Gg, Gg, Rb^Gvs, Rb^Gvs, Rb^Gvs, Rb^Gvs, Rb^Gvs, Rb^Gvs, Re, Gg, Gg, Gg, Gg, Gs^Edt, Ce^Edt, Re^Gvs, Re^Gvs, Re^Gvs, Re^Gvs, Rb^Gvs, Gs^Eff, Gs^Eff, Gs, Gs, Gs, Re, Re, Rr, Rr^Vhc, Rp, Isa, Isa, Rp, Ww^Bw\, Wo, Wo, Ww, Ds^Esd, Hd, Gg^Qhh, Gg, Gg, Hh^Fms, Hh^Vhh, Hh
Re^Gvs, Re^Gvs, Re^Gvs, Re^Gvs, Re^Gvs, Re^Gvs, Re^Gvs, Rb^Gvs, Rb^Gvs, Re, Re, Gg^Fms, Gg^Fms, Gg, Ce, Ke, Gd, Re^Gvs, Gd^Eff, Gs^Eff, Gs, Gs, Gs, Gs, Re, Re, Gs^Fdw, Gs^Fms, Rr, Rp, Rr^Vhc, Rp, Ww^Ewf, Ww^Ewl, Ww, Ww, Ds, Hd, Rd^Qhh, Gd^Qhh, Gg, Gg, Gg, Gg, Hh
Re^Gvs, Re^Gvs, Re^Gvs, Re^Gvs, Re^Gvs, Re^Gvs, Re^Gvs, Rb^Gvs, Rb^Gvs, Re^Gvs, Re^Gvs, Gg^Fds, Gg^Fds, Re^Es, Re, Ce, Gd^Edt, Gs, Gd, Gd, Gs, Gd, Gs, Gd, Rr, Re, Rp, Gg^Fms, Re, Gs^Fdw, Re, Gg^Fms, Ww, Ww, Wo, Ww, Wwr, Gg^Qhh, Gg, Gg, Hh, Gg^Qhh, Gg, Hh, Hh
Re^Gvs, Re^Gvs, Re^Gvs, Re^Gvs, Re^Gvs, Re^Gvs, Rb^Gvs, Rb^Gvs, Rb^Gvs, Rb^Gvs, Re^Gvs, Re^Gvs, Re, Re, Re, Gg, Re, Rb, Gs, Gd, Re, Gs, Re^Edt, Rr, Rr, Isa^Ebn, Rp^Edt, Rp^Edt, Re, Re^Es, Re^Edt, Re, Gs, Ww, Wo, Wo, Wo, Rd^Qhh, Gg^Qhh, Hh, Hh, Gg, Gg, Gg, Gg
Re, Re, Re, Re, Re, Re, Gg, Rb^Gvs, Re^Gvs, Re^Gvs, Gs^Fms, Gs^Fms, Gs^Fms, Gg, Gg, Re^Es, Gg^Eff, Re^Eff, Rb^Gvs, Re^Gvs, Re^Gvs, Re, Re, Ch^Edt, Rr^Vhc, Rp^Edt, Ch, Rp, Re, Re^Es, Re, Gs^Fdw, Gg^Fms, Wwr, Gg^Fds, Wo, Wo, Ww, Gg^Qhh, Gg, Hh, Hh, Gg, Gg, Gg
Gg, Gg, Gg, Gg, Gg, Gg, Gg, Gg, Gg, Gg, Gg^Fms, Gs^Fms, Gg, Gg, Gg^Eff, Gg^Eff, Rb^Gvs, Rb^Gvs, Rb^Gvs, Re^Gvs, Re^Gvs, Re, Gg^Fms, Gs, Re, Rr^Vhc, Re, Re^Edt, Gs, Gs, Gs, Re, Gs^Vh, Gg^Fms, Wwr, Ww, Wo, Ww, Ww, Gg^Qhh, Gg, Hh, Gg, Gg, Gs
Gs^Fds, Gs^Fds, Gs^Fds, Gs^Fds, Gs^Fds, Gg, Gg, Gg, Gg^Fms, Gg^Fms, Gs^Fds, Gs^Fds, Gs^Fds, Gg, Gg, Gg^Eff, Rb, Rb^Gvs, Rb^Gvs, Rb^Gvs, Re^Vh, Re, Gg, Gg, Gs, Re, Re^Es, Gs, Gs, Gs, Gg^Fms, Gs, Gg^Fds, Ww, Ww, Wo, Ww, Ww, Wwf, Gg^Qhh, Hh, Gg, Gg, Gg, Gs
Gg^Fds, Gg^Fds, Gg^Fds, Gg^Fds, Gg^Fds, Gg, Gg, Gg, Gg, Gg^Fds, Gs^Fds, Gs^Fds, Gg, Gg, Gg, Gg, Gg, Re^Edt, Gs^Fds, Ce^Edt, Gs, Gs^Fds, Gs^Fds, Gs^Qhhf, Gg^Qhh, Re^Es, Ds^Esd, Re, Re, Re^Es, Ww, Gg, Ww, Ww, Wo, Ww, Ww, Ww, Wwf, Gs^Qhh, Gs, Gg, Gs, Gs, Re
Gs^Fds, Gs^Fds, Gs^Fds, Gs^Fds, Gs^Fds, Gg^Fds, Gg, Gg, Re^Eff, Gg, Gg, Gg, Gg^Qhh, Gg^Qhh, Gg^Qhh, Gg^Qhh, Gg^Qhh, Gg, Gg, Gs^Fms, Gg^Qhh, Gs^Fms, Gs^Qhh, Gg^Qhh, Gg, Gg^Qhh, Ds^Esd, Ds, Ch, Re, Ww^Bw\, Wo, Wo, Ww, Wo, Ww, Ww, Ww, Ww, Wwf, Gs, Gs, Re, Re, Re^Gvs
Gg, Gg, Gg, Gg, Gg, Gg, Rb^Eff, Rb^Eff, Re^Gvs, Re^Eff, Re^Eff, Gg^Qhh, Re^Eff, Rb^Eff, Rb^Gvs, Rb^Gvs, Rb^Gvs, Gg^Qhh, Gg^Qhh, Gg^Qhh, Rb^Gvs, Gg^Qhh, Gg^Qhh, Gg, Gg^Qhh, Gg^Qhh, Ww, Ww, Ww, Ww, Wo, Wo, Wo, Wo, Wo, Ww, Ww, Ww, Wwf, Wwf, Rb, Gs, Re^Gvs, Re^Vh, Re^Gvs
Gs, Gs, Gg, Gg, Rb^Eff, Rb^Eff, Re^Gvs, Re^Gvs, Re^Gvs, Re^Wm, Re^Gvs, Re^Eff, Re^Eff, Re^Gvs, Rb^Gvs, Rb^Gvs, Rb^Gvs, Rb^Gvs, Rb^Gvs, Rb^Gvs, Re^Gvs, Rb^Gvs, Rb, Gg, Gg^Qhh, Ww, Ww, Ww, Wo, Ww, Wo, Wo, Wo, Wo, Ww, Ww, Gs, Gs, Rb, Rb^Vh, Re^Gvs, Re^Gvs, Re^Ecf, Re^Gvs, Re^Gvs
Gs, Gs, Gs, Re, Re, Re^Gvs, Re^Gvs, Re^Gvs, Re^Gvs, Re^Gvs, Re^Gvs, Re^Gvs, Re^Gvs, Rb^Eff, Gg^Vh, Rb^Gvs, Rb^Gvs, Rb^Gvs, Re^Gvs, Re^Gvs, Re^Gvs, Rb^Gvs, Gg^_mh, Gg^Qhh, Ww, Ww, Ww, Wo, Wo, Wo, Wo, Wo, Ww, Wo, Ww^Ewf, Ww, Ds^Ewsh, Gs, Re^Gvs, Re^Gvs, Re^Gvs, Re^Gvs, Re^Gvs, Re^Gvs, Re^Eff
Gg, Gg, Gg, Gg, Gg, Re^Gvs, Rb^Gvs, Re^Gvs, Re^Gvs, Re^Gvs, Re^Gvs, Re^Gvs, Re^Ecf, Re^Gvs, Gg, Gg, Rb, Rb^Gvs, Re^Gvs, Re^Gvs, Re^Gvs, Gg, Gg^Qhh, Gg^Qhh, Ww, Ww, Ww, Wo, Wo, Wo, Wo, Wo, Ww, Ww, Ds, Ds, Ds, Gs^Eff, Rb^Eff, Re^Gvs, Re^Gvs, Re^Gvs, Re^Eff, Re^Eff, Re^Gvs
Gg, Gg, Gg, Gg, Re, Rb^Gvs, Rb^Gvs, Rb^Gvs, Rb^Gvs, Re^Gvs, Rb^Eff, Rb^Gvs, Gg, Gg, Hh, Hh, Hh, Rb^Gvs, Rb^Gvs, Re^Gvs, Re^Qhh, Re^Qhh, Ww, Ww, Ww, Ww, Ww, Ww, Ww, Ww, Ww, Ww, Ww, Ww, Wwf, Gs, Gg, Gg, Gg, Rb^Eff, Rb^Eff, Re^Eff, Re^Gvs, Re^Gvs, Re^Gvs
Gg, Gg, Re, Re, Re^Gvs, Re^Gvs, Rb^Gvs, Rb^Gvs, Re^Eff, Rb^Eff, Rb^Eff, Gg^Vh, Gg, Gg, Gg, Hh, Hh, Hh, Hh^Qhh, Rb^Qhh, Ww, Ww, Ww, Ww, Wo, Wo, Ww, Ww, Ww, Ww, Wwf, Ww, Wwf, Ww, Wwf, Ds, Dd, Gg, Gg^Eff, Gg^Eff, Rb^Gvs, Rb^Gvs, Rb^Gvs, Re^Gvs, Re^Gvs
Re^Gvs, Re^Gvs, Re^Gvs, Re^Gvs, Re^Gvs, Re^Gvs, Re^Gvs, Re^Eff, Re^Gvs, Rb^Gvs, Re^Gvs, Rb^Eff, Re^Eff, Gg, Gg, Hh, Hh, Hh, Hh^Qhh, Ds, Ww, Ww, Wo, Wo, Wo, Wo, Ww, Ww, Ds^Esd, Ds, Dd, Dd, Ds, Wwf, Gd, Dd, Gs, Gs^Eff, Gs^Eff, Rb^Gvs, Rb^Gvs, Rb^Gvs, Rb^Gvs, Rb^Gvs, Rb^Gvs
Re^Gvs, Re^Gvs, Re^Gvs, Re^Gvs, Re^Gvs, Re^Gvs, Re^Gvs, Re^Gvs, Re^Gvs, Re^Gvs, Re^Gvs, Re^Gvs, Re^Gvs, Re^Gvs, Re, Gg, Gg, Hh^Qhh, Hd^Esd, Ds^Esd, Ww, Ww, Wo, Wo, Ww, Wo, Ww, Ww, Dd, Dd^Esd, Dd, Dd, Ds^Ewsh, Ds, Gd, Gd, Gs, Gs, Gs, Gg^Eff, Rb^Eff, Rb^Gvs, Rb^Gvs, Rb^Gvs, Rb^Gvs
Re^Gvs, Re^Gvs, Re^Gvs, Re^Gvs, Re^Gvs, Re^Gvs, Re^Gvs, Re^Gvs, Re^Gvs, Re^Gvs, Rb^Gvs, Re^Gvs, Re, Re, Gg^Efm, Gg, Gg, Hh^Qhh, Ds, Ww, Ww, Wo, Wo, Wo, Ww, Ww, Dd, Dd, Dd, Dd, Ds, Ds, Gd, Gd, Gd, Gd, Hh, Gs, Gg, Gs, Gs, Rb^Eff, Gs, Rb^Gvs, Rb
Re, Re^Gvs, Re^Gvs, Re^Gvs, Re^Gvs, Re^Gvs, Rb^Gvs, Rb^Gvs, Rb^Gvs, Rb^Gvs, Rb^Gvs, Re, Gg, Gg^Efm, Gg^Efm, Gg^Efm, Gg^Qhh, Gg^Qhh, Ww, Ww, Wo, Wo, Wo, Ww, Ww, Ww, Gd, Gd, Gd, Gs, Hh, Hh, Gs, Hh, Hh, Gs, Hh, Hh, Gs, Gs, Gs, Gs, Gs, Gs, Gs
Gg, Gg, Gg, Rb^Gvs, Rb^Gvs, Rb^Gvs, Rb, Rb^Gvs, Rb^Gvs, Rb^Gvs, Gs, Gg, Gg^Efm, Gg^Efm, Gg^Efm, Gg, Gg^Qhh, Ww, Ww, Wo, Wo, Wo, Wo, Ww, Ww, Gd, Dd, Gd, Dd, Dd, Gs, Hh, Gs, Gs, Gs, Hh, Gs, Gs, Gs, Gs, Hh, Gs, Hh, Hh, Gs
Gg, Gg, Gg, Gg, Gg, Gg, Gg, Rb, Gg, Gg, Gg, Gg^Efm, Gg^Efm, Gg^Efm, Gg^Qhh, Gg^Qhh, Ww, Ww, Ww, Wo, Wo, Wo, Ww, Ww, Dd, Dd, Dd, Dd, Ds, Gd, Gd, Gs, Gs, Gs, Gs, Gs, Gs, Hh, Gs, Gs, Gs, Hh, Hh, Gs, Gs
Gs, Gs, Gs, Gs, Gs, Gg^Efm, Gg^Efm, Gg^Efm, Gg, Gg, Gg^Efm, Gg^Efm, Gg, Gg, Gg^Qhh, Ww, Ww, Ww, Wo, Wo, Wo, Ww, Ww, Ww, Dd, Dd^Ewsh, Ds, Ds, Gs, Gd, Gd, Gd, Gs, Gs, Gs, Gs, Hh, Hh, Gs, Hh, Gs, Gs, Gs, Hh, Gs
