Gg, Gg, Gg^Fms, Gs^Fds, Gs^Fds, Gg^Fds, Rb, Rb, Aa, Re, Re, Re, Re, Re, Re, Re, Re, Rb, Rb, Gg, Gg, Re, Re, Gs, Gd^Fms, Gd^Fms, Gd^Es, Ww, Ww, Ww, Ww, Ww, Re^Qhh, Gs^Qhh, Re^Qhh, Re^Qhh, Rb^Eff, Re^Qhh, Gg^Qhh, Gs^Qhh, Gs^Fdw, Rr^Es, Gg, Gs^Fdw, Gs^Fdw
Gg^Fds, Gg, Gs^Fms, Aa^Fdw, Aa^Fdw, Aa, Aa, Aa, Rb, Re, Re, Re, Re, Re, Re, Rb, Rb, Rb, Gs, Rb, Gg, Gd, Gd^Edt, Re^Es, Gd, Ce, Ww, Ww, Wo, Ww, Aa^Qhh, Gs^Qhh, Aa, Aa, Aa, Re, Re, Rb^Eff, Re^Eff, Gg, Gg, Gg, Gg, Gs^Fdw, Gg
Aa, Gg, Gg, Gg, Gg, Aa^Fdw, Gg^Fms, Aa^Fdw, Aa^Fdw, Gg, Gg, Re, Rb, Re, Gs, Rb, Gs, Gs, Gs, Gg, Gg, Ce, Gd, Re, Gs^Edt, Gs, Ww, Wo, Ww, Ww, Aa^Qhh, Aa^_mh, Aa, Aa, Rb, Rb, Rb, Re, Re, Gs^Eff, Gs^Wm, Gg, Re, Gg, Re
Aa^Fdw, Aa^Fdw, Gs^Fds, Gs^Fds, Gs^Fds, Gg^Fms, Aa, Gs^Fms, Aa^Fdw, Gg, Gs^Fms, Gg, Gg, Gs, Aa, Gg, Aa^Eff, Gs^Eff, Gd^Eff, Gs, Gs^Eff, Gs^Eff, Gs^Fmw, Re, Re^Edt, Ww, Ww, Wo, Ww, Ww, Ww, Aa^Qhh, Aa^Qhh, Aa, Rb, Aa, Rb, Re, Gs^Edt, Aa, Re^Es, Re, Gs^Fdw, Re, Gs^Fds
Gs^Fms, Gs^Fms, Gs^Fms, Gs^Fms, Gs^Fms, Aa^Fdw, Aa^Fdw, Gs^Fms, Gs^Fds, Gs^Fds, Gg, Gs^Fdw, Aa, Aa, Ce, Aa, Aa, Aa, Aa, Gd, Rb, Gs^Eff, Rb, Re, Re, Ww, Cha, Ww, Ww, Ww, Ww, Ww, Ww, Cha^Qhh, Rr^Edt, Rb, Re^Edt, Gs, Re, Re, Aa, Aa^Es, Aa^Fmw, Aa^Fmw, Aa^Fmw
Gg^Fms, Gs^Fdw, Aa^Fdw, Aa^Fdw, Aa^Fdw, Aa^Fdw, Aa^Fdw, Gg, Aa^Fdw, Gg, Gg, Gg, Gg, Aa, Rb, Aa, Aa, Aa, Aa, Rb, Aa, Rb, Rb, Re^Vh, Re, Aa, Cha, Rr, Rp, Ww^Ewf, Ww^Ewl, Ww, Ww^Bw/, Rr^Qhh, Gs^Qhh, Rr, Gg^Edt, Re, Gg^Fmw, Gs^Fdw, Aa^Fdw, Aa^Fdw, Aa^Fdw, Aa^Fdw, Aa^Fdw
Gg, Gg, Aa, Gg, Gs^Vl, Gs^Fdw, Aa^Fdw, Aa, Aa, Gg^Fms, Gg, Gg, Aa, Rb, Rb, Re, Aa, Aa, Aa, Aa, Aa, Rb, Rb, Gs^Edt, Rr^Vh, Re^Es, Rp, Cha, Cha^Edt, Cha, Rr, Ww^Bw/, Ww, Ww, Ww, Cha^Qhh, Aa^Qhh, Aa, Aa, Aa^Fmw, Gg^Fmw, Aa^Fmw, Aa^Fdw, Aa^Fdw, Aa^Fdw
Aa, Aa, Aa, Aa, Gg, Gs^Fdw, Aa^Fms, Gg, Aa, Aa, Aa, Ce, Rb, Rb, Aa, Aa, Aa, Aa, Aa, Aa, Aa, Rb, Re, Re, Cha, Rp, Rp, Rr^Edt, Rr^Edt, Rr, Cha^Ebn, Rr^Vhc, Ww^Ewl, Wo, Wo, Ww, Ww, Gg^Qhh, Gg^Qhhf, Gs^Fmw, Gs^Vl, Aa^Fmw, Aa^Fdw, Aa^Fmw, Ha^Fmw
Aa, Aa, Aa, Aa, Gg, Gg, Gs^Fms, Gs^Fms, Gg, Gg, Aa, Ce, Ce, Aa, Aa, Re, Re^Vh, Aa, Aa, Re, Re, Re, Gs, Re, Cha^Edt, Rr, Rp^Edt, Rr, Rr^Es, Rr^Vhc, Cha, Cha, 2 Kh, Wo, Wo, Wo, Ww, Ww, Gg^Qhh, Gg, Aa^Fmw, Aa^Fmw, Ha, Ha^Fmw, Ha^Fmw
Aa, Aa, Gg, Gg, Rb, Rb, Rb, Gg, Gg, Gg, Aa, Aa, Aa, Ce, Rb, Rb, Re, Re, Rb^Wm, Rb, Re^Eff, Re, Gs, Aa^Edt, Aa^Edt, Cha^Edt, Rr, Rr, Rr, Rr, Rr, Rr^Edt, Cha, Ww^Bw/, Wo, Wo, Wo, Ww, Gg^Qhhf, Gs^Fmw, Hh^Fmw, Aa, Aa, Ha^Fmw, Gg
Aa, Aa, Aa, Rb, Rb, Rb, Rb, Rb, Re, Gg, Gg, Aa, Gg, Gs^Edt, Ce^Edt, Re, Re, Re, Re, Rb, Gs^Eff, Gs^Eff, Gs, Aa, Aa, Aa, Re, Rr, Rr^Vhc, Rp, Rp^Edt, Cha^Edt, Cha^Ebn, Ww^Bw/, Wo, Wo, Ww, Ds^Esd, Hd, Gg^Qhh, Gg, Aa, Ha^Fmw, Ha, Ha
Aa, Aa, Aa, Aa, Re, Re, Re, Rb, Rb, Re, Re, Gg^Fmw, Gg^Fmw, Aa, Ce, Ke, Gd, Re, Gd^Eff, Gs^Eff, Gs, Gs, Gs, Gs, Re, Re, Re, Cha, Rr, Rp, Rr^Vhc, Rr^Vhc, Ww^Ewf, Ww^Ewl, Ww, Ww, Ds, Hd, Rd^Qhh, Gd^Qhh, Gg, Aa, Aa, Aa, Ha
Aa, Aa, Re, Re, Re, Aa, Aa, Rb, Rb, Re, Re, Gg^Fdw, Aa^Fdw, Aa^Es, Re, Ce, Gd^Edt, Gs, Gd, Gd, Gs, Gd, Gs, Gd, Rr^Vhc, Re, Rp, Gs, Re, Cha, Cha^Edt, Cha, Ww, Ww, Wo, Ww, Wwr, Gg^Qhh, Gg, Gg, Hh, Gg^Qhh, Gg, Hh, Hh
Re, Re, Re, Re, Aa, Aa, Aa, Rb, Rb, Rb, Re, Re, Re, Re, Re, Gg, Re, Rb, Gs, Gd, Re, Gs, Re^Edt, Cha, Rr, Rp^Vhc, Rp^Edt, Rp^Edt, Re, Aa^Es, Aa^Edt, Aa, Aa, Ww, Wo, Wo, Wo, Rd^Qhh, Gg^Qhh, Hh, Hh, Gg, Gg, Gg, Gg
Re, Re, Re, Aa, Re, Aa, Gg, Rb, Re, Re, Gs^Fmw, Gs^Fmw, Gs^Fmw, Aa, Aa, Re^Es, Aa^Eff, Re^Eff, Re, Re, Aa, Re, Re, Cha^Edt, Cha, Rp^Edt, Cha, Rp, Aa, Re^Es, Re, Gg^Fdw, Gg^Fdw, Wwr, Aa^Fdw, Wo, Wo, Ww, Gg^Qhh, Gg, Hh, Hh, Gg, Gg, Gg
Gg, Gg, Aa, Aa, Gg, Aa, Gg, Gg, Gg, Gg, Aa^Fmw, Aa^Fmw, Aa, Aa, Aa^Eff, Aa^Eff, Re, Re, Aa, Aa, Aa, Re, Gg^Fmw, Aa, Aa, Cha, Re, Re^Edt, Gs, Aa, Aa, Re, Gs^Vh, Aa^Fdw, Wwr, Ww, Wo, Ww, Ww, Gg^Qhh, Gg, Hh, Gg, Gg, Gs
Gs^Fdw, Aa^Fdw, Aa^Fdw, Aa^Fdw, Aa^Fdw, Aa, Gg, Gg, Gg^Fmw, Gg^Fmw, Aa^Fdw, Aa^Fdw, Aa^Fdw, Aa, Aa, Aa^Eff, Rb, Re, Aa, Aa, Re^Vh, Re, Gg, Aa, Gs, Aa, Re^Es, Gs, Aa, Aa, Aa^Fdw, Aa, Gg^Fdw, Ww, Ww, Wo, Ww, Ww, Wwf, Gg^Qhh, Hh, Gg, Gg, Gg, Gs
Gg^Fmw, Gg^Fmw, Gg^Fmw, Gg^Fmw, Aa^Fmw, Aa, Gg, Gg, Gg, Gg^Fds, Gs^Fdw, Aa^Fdw, Aa, Aa, Aa, Aa, Gg, Re^Edt, Gs^Fdw, Ce^Edt, Gs, Gs^Fdw, Gs^Fdw, Gs^Fdw, Aa^Qhh, Re^Es, Ds^Esd, Re, Re, Re^Es, Ww, Gg, Ww, Ww, Wo, Ww, Ww, Ww, Wwf, Gs^Qhh, Gs, Gg, Gs, Gs, Re
Gs^Fdw, Gs^Fdw, Gs^Fdw, Gs^Fdw, Gs^Fdw, Gg^Fmw, Gg, Gg, Re^Eff, Gg, Gg, Aa, Aa^Qhh, Aa^Qhh, Gg^Qhh, Gg^Qhh, Gg^Qhh, Gg, Gg, Gs^Fdw, Gg^Qhh, Gs^Fdw, Gs^Qhh, Aa^Qhh, Aa, Aa^Qhh, Ds^Esd, Ds, Ch, Re, Ww^Bw\, Wo, Wo, Ww, Wo, Ww, Ww, Ww, Ww, Wwf, Gs, Gs, Re, Re, Re
Gg, Gg, Gg, Gg, Gg, Gg, Rb^Eff, Rb^Eff, Re, Re^Eff, Re^Eff, Gg^Qhh, Re^Eff, Rb^Eff, Rb, Rb, Aa, Aa^Qhh, Aa^Qhh, Gg^Qhh, Rb, Gg^Qhh, Gg^Qhh, Gg, Aa^Qhh, Aa^Qhh, Ww, Ww, Ww, Ww, Wo, Wo, Wo, Wo, Wo, Ww, Ww, Ww, Wwf, Wwf, Rb, Gs, Re, Re^Vh, Re
Aa, Aa, Aa, Gg, Rb^Eff, Rb^Eff, Re, Re, Re, Re^Wm, Re, Re^Eff, Re^Eff, Re, Rb, Rb, Aa, Aa, Aa, Aa, Re, Rb, Rb, Aa, Aa^Qhh, Ww, Ww, Ww, Wo, Ww, Wo, Wo, Wo, Wo, Ww, Ww, Aa, Aa, Rb, Rb^Vh, Re, Re, Re, Re, Re
Aa, Aa, Aa, Re, Re, Re, Aa, Aa, Aa, Re, Re, Re, Re, Rb^Eff, Gg^Vh, Rb, Aa, Aa, Aa, Aa, Re, Rb, Gg^_mh, Gg^Qhh, Ww, Ww, Ww, Wo, Wo, Wo, Wo, Wo, Ww, Wo, Ww^Ewf, Ww, Ds, Aa, Aa, Aa, Re, Re, Re, Re, Re^Eff
Gg, Aa, Gg, Gg, Gg, Aa, Aa, Aa, Aa, Re, Aa, Re, Re, Re, Gg, Gg, Rb, Aa, Aa, Re, Aa, Aa, Aa^Qhh, Gg^Qhh, Ww, Ww, Ww, Wo, Wo, Wo, Wo, Wo, Ww, Ww, Aa, Aa, Ds, Aa^Eff, Rb^Eff, Aa, Re, Re, Re^Eff, Re^Eff, Re
Aa, Aa, Aa, Aa, Re, Aa, Aa, Aa, Rb, Aa, Rb^Eff, Rb, Gg, Gg, Hh, Hh, Hh, Rb, Aa, Aa, Re^Qhh, Re^Qhh, Ww, Ww, Ww, Ww, Ww, Ww, Ww, Ww, Ww, Ww, Ww, Ww, Wwf, Gs, Gg, Gg, Gg, Rb^Eff, Rb^Eff, Re^Eff, Re, Re, Re
Gg, Aa, Aa, Re, Re, Re, Rb, Rb, Re^Eff, Rb^Eff, Rb^Eff, Gg^Vh, Gg, Gg, Gg, Hh, Hh, Hh, Hh^Qhh, Rb^Qhh, Ww, Ww, Ww, Ww, Wo, Wo, Ww, Ww, Ww, Ww, Wwf, Ww, Wwf, Ww, Wwf, Ds, Dd, Aa, Gg^Eff, Gg^Eff, Rb, Rb, Aa, Re, Aa
Re, Re, Aa, Re, Re, Re, Re, Re^Eff, Re, Rb, Re, Rb^Eff, Re^Eff, Gg, Gg, Hh, Hh, Hh, Hh^Qhh, Ds, Ww, Ww, Wo, Wo, Wo, Wo, Ww, Ww, Aa, Aa, Dd, Aa, Aa, Wwf, Aa, Dd, Aa, Aa^Eff, Gs^Eff, Rb, Rb, Aa, Rb, Aa, Aa
Re, Re, Re, Re, Aa, Re, Re, Re, Aa, Re, Re, Re, Re, Re, Aa, Gg, Aa, Hh^Qhh, Hd^Esd, Ds^Esd, Ww, Ww, Wo, Wo, Ww, Wo, Ww, Ww, Aa, Aa, Aa, Aa, Aa, Aa, Aa, Aa, Aa, Aa, Aa, Aa^Eff, Aa^Eff, Rb, Rb, Aa, Rb
Aa, Aa, Aa, Aa, Aa, Aa, Re, Re, Re, Aa, Aa, Aa, Aa, Aa, Aa, Aa, Aa, Hh^Qhh, Ds, Ww, Ww, Wo, Wo, Wo, Ww, Ww, Dd, Dd, Dd, Aa, Ds, Ds, Aa, Aa, Aa, Aa, Ha, Gs, Gg, Aa, Aa, Aa^Eff, Aa^Eff, Aa, Rb
Re, Aa, Aa, Aa, Aa, Aa, Aa, Rb, Aa, Rb, Rb, Aa, Aa, Aa, Aa, Aa, Gg^Qhh, Aa^Qhh, Ww, Ww, Wo, Wo, Wo, Ww, Ww, Ww, Aa, Aa, Gd, Aa, Ha, Ha, Aa, Ha, Ha, Gs, Ha, Ha, Aa, Aa, Gs, Aa, Gs, Aa, Aa
Aa, Aa, Aa, Aa, Aa, Aa, Aa, Rb, Aa, Aa, Aa, Aa, Aa, Aa, Aa, Aa, Aa^Qhh, Ww, Ww, Wo, Wo, Wo, Wo, Ww, Ww, Aa, Dd, Aa, Dd, Dd, Aa, Ha, Aa, Aa, Aa, Ha, Aa, Gs, Aa, Aa, Ha, Gs, Ha, Ha, Aa
Aa, Aa, Aa, Aa, Aa, Aa, Aa, Aa, Aa, Aa, Aa, Aa, Aa, Aa, Aa, Aa^Qhh, Ww, Ww, Ww, Wo, Wo, Wo, Ww, Ww, Dd, Dd, Dd, Dd, Ds, Aa, Aa, Aa, Aa, Aa, Aa, Aa, Aa, Ha, Aa, Aa, Aa, Ha, Ha, Aa, Aa
Gs, Aa, Aa, Aa, Aa, Aa, Aa, Aa, Aa, Aa, Aa, Aa, Aa, Aa, Gg^Qhh, Ww, Ww, Ww, Wo, Wo, Wo, Ww, Ww, Ww, Dd, Aa, Ds, Ds, Aa, Aa, Aa, Aa, Aa, Gs, Gs, Gs, Hh, Ha, Gs, Ha, Aa, Aa, Gs, Ha, Gs
